VPDUNIT_ID,PROXYCODE,COMPLIANCE_RATE,SITE_TYPE,SITE_NAME,RD_CODE,SITE_NUMBER,AFOREST_CODE,Proxy,Year,APR_JUN,JUL_SEP,OCT_DEC,JAN_MAR,Total_Proxy_Visits,APR_JUN_COUNT_ADJUSTED,JUL_SEP_COUNT_ADJUSTED,OCT_DEC_COUNT_ADJUSTED,JAN_MAR_COUNT_ADJUSTED,TOTAL_COUNT_ADJUSTED
504,FR1,   1,DUDS,Mammoth Mtn. Ski Area Summer,Mammoth RD,13,A05004,2,2006,0,68526,0,0,68526,0,68526,0,0,68526
504,SV1,   1,DUDS,June Mountain Ski Area,Mono RD,9384,A05004,2,2006,12533,0,13954,68536,95023,12533,0,13954,68536,95023
504,SV1,   1,DUDS,Mammoth Mt. Ski Area Winter,Mammoth RD,9497,A05004,2,2006,344838,6486,281715,862036,1495075,344838,6486,281715,862036,1495075
504,SV1,   1,DUDS,Tamarack Nordic Ski,Mammoth RD,9522,A05004,2,2006,1030,0,2149,8616,11795,1030,0,2149,8616,11795
504,DUR5,   1,OUDS,Table Mountain Group CG,White Mountain RD,66,A05004,2,2006,19,62,0,0,81,19,62,0,0,81
504,DUR4,   1,OUDS,Silver Lake Resort RV Park,Mono RD,114,A05004,2,2006,3016,6713,629,0,10358,3016,6713,629,0,10358
504,RE4,   1,OUDS,Tom's Place,White Mountain RD,130,A05004,2,2006,1015,1268,487,633,3403,1015,1268,487,633,3403
504,RE4,   1,OUDS,Mammoth Recreation Inc.,Mammoth RD,9325,A05004,2,2006,12395,10652,8972,16116,48135,12395,10652,8972,16116,48135
504,DUR4,   1,OUDS,Tioga Lake CG,Mono RD,9343,A05004,2,2006,0,1217,140,0,1357,0,1217,140,0,1357
504,DUR4,   1,OUDS,Big Bend CG,TOTAL,9345,A05004,2,2006,441,1721,78,0,2240,441,1721,78,0,2240
504,DUR4,   1,OUDS,Sawmill Walk-in CG,Mono RD,9347,A05004,2,2006,0,431,8,0,439,0,431,8,0,439
504,DUR4,   1,OUDS,Saddlebag Lake CG,Mono RD,9348,A05004,2,2006,0,1862,175,0,2037,0,1862,175,0,2037
504,DUR4,   1,OUDS,Ellery Lake CG,Mono RD,9349,A05004,2,2006,110,1288,108,0,1506,110,1288,108,0,1506
504,DUR4,   1,OUDS,Silver Lake CG,Mono RD,9356,A05004,2,2006,2454,5175,0,0,7629,2454,5175,0,0,7629
504,DUR4,   1,OUDS,Reversed Creek CG,Mono RD,9360,A05004,2,2006,2280,823,0,0,3103,2280,823,0,0,3103
504,DUR4,   1,OUDS,Gull Lake CG,Mono RD,9361,A05004,2,2006,511,894,0,0,1405,511,894,0,0,1405
504,DUR4,   1,OUDS,June Lake CG,Mono RD,9362,A05004,2,2006,731,1837,0,0,2568,731,1837,0,0,2568
504,DUR4,   1,OUDS,Pine Cliff Trailer Park,Mono RD,9363,A05004,2,2006,0,1037,82,0,1119,0,1037,82,0,1119
504,RE4,   1,OUDS,Tioga Pass Resort,Mono RD,9366,A05004,2,2006,159,1226,58,260,1703,159,1226,58,260,1703
504,RE4,   1,OUDS,Silver Lake Resort Cabins,Mono RD,9367,A05004,2,2006,699,1363,193,0,2255,699,1363,193,0,2255
504,RE4,   1,OUDS,Big Rock Landing Resort,Mono RD,9371,A05004,2,2006,0,0,0,0,0,0,0,0,0,0
504,RE4,   1,OUDS,Boulder Lodge,Mono RD,9372,A05004,2,2006,2005,3709,1737,2249,9700,2005,3709,1737,2249,9700
504,DUR4,   1,OUDS,Grant Lake Marina,Mono RD,9381,A05004,2,2006,0,0,0,0,0,0,0,0,0,0
504,DUR4,   1,OUDS,Oh! Ridge CG,Mono RD,9393,A05004,2,2006,1831,5566,0,0,7397,1831,5566,0,0,7397
504,DUR4,   1,OUDS,Old Shady Rest CG,Mammoth RD,9428,A05004,2,2006,476,2083,0,0,2559,476,2083,0,0,2559
504,DUR4,   1,OUDS,Agnew Meadows CG,Mammoth RD,9432,A05004,2,2006,0,229,0,0,229,0,229,0,0,229
504,DUR4,   1,OUDS,Soda Springs CG,Mammoth RD,9433,A05004,2,2006,33,1097,0,0,1130,33,1097,0,0,1130
504,DUR4,   1,OUDS,Pumice Flat CG,Mammoth RD,9434,A05004,2,2006,28,1106,0,0,1134,28,1106,0,0,1134
504,DUR4,   1,OUDS,Minaret Falls CG,Mammoth RD,9435,A05004,2,2006,52,1454,0,0,1506,52,1454,0,0,1506
504,DUR4,   1,OUDS,Reds Meadow CG,Mammoth RD,9436,A05004,2,2006,132,2829,55,0,3016,132,2829,55,0,3016
504,DUR4,   1,OUDS,Twin Lakes CG,Mammoth RD,9439,A05004,2,2006,845,6422,277,0,7544,845,6422,277,0,7544
504,DUR4,   1,OUDS,Coldwater CG,Mammoth RD,9440,A05004,2,2006,267,4000,0,0,4267,267,4000,0,0,4267
504,DUR4,   1,OUDS,Lake George CG,Mammoth RD,9441,A05004,2,2006,37,1945,0,0,1982,37,1945,0,0,1982
504,DUR4,   1,OUDS,Lake Mary CG,Mammoth RD,9442,A05004,2,2006,47,2361,0,0,2408,47,2361,0,0,2408
504,DUR4,   1,OUDS,Pine City CG,Mammoth RD,9443,A05004,2,2006,109,593,0,0,702,109,593,0,0,702
504,DUR4,   1,OUDS,Sherwin Creek CG,Mammoth RD,9444,A05004,2,2006,958,2885,0,0,3843,958,2885,0,0,3843
504,DUR4,   1,OUDS,Convict Lake CG,Mammoth RD,9445,A05004,2,2006,8452,6625,3665,0,18742,8452,6625,3665,0,18742
504,DUR5,   1,OUDS,Agnew Meadows Group CG,Mammoth RD,9448,A05004,2,2006,0,118,0,0,118,0,118,0,0,118
504,DUR5,   1,OUDS,Pumice Flat Group CG,Mammoth RD,9449,A05004,2,2006,0,189,0,0,189,0,189,0,0,189
504,DUR4,   1,OUDS,New Shady Rest CG,Mammoth RD,9464,A05004,2,2006,1211,4491,284,0,5986,1211,4491,284,0,5986
504,DUR5,   1,OUDS,Pine Glen Group CG,Mammoth RD,9465,A05004,2,2006,161,933,0,0,1094,161,933,0,0,1094
504,RE4,   1,OUDS,Woods Lodge,Mammoth RD,9468,A05004,2,2006,301,2123,129,0,2553,301,2123,129,0,2553
504,RE4,   1,OUDS,Wildyrie Lodge,Mammoth RD,9469,A05004,2,2006,77,1026,0,0,1103,77,1026,0,0,1103
504,RE4,   1,OUDS,Tamarack Lodge,Mammoth RD,9470,A05004,2,2006,1488,2927,1505,2683,8603,1488,2927,1505,2683,8603
504,RE4,   1,OUDS,Crystal Crag Lodge,Mammoth RD,9471,A05004,2,2006,630,1890,315,0,2835,630,1890,315,0,2835
504,RE4,   1,OUDS,Convict Lake Resort,Mammoth RD,9472,A05004,2,2006,1541,2470,1543,1034,6588,1541,2470,1543,1034,6588
504,RE4,   1,OUDS,Reds Meadow Resort,Mammoth RD,9480,A05004,2,2006,11,494,0,0,505,11,494,0,0,505
504,DUR4,   1,OUDS,Mammoth Mtn RV Park,Mammoth RD,9514,A05004,2,2006,4962,10126,2517,3910,21515,4962,10126,2517,3910,21515
504,DUR4,   1,OUDS,Big Meadow CG,White Mountain RD,9532,A05004,2,2006,681,2501,0,0,3182,681,2501,0,0,3182
504,DUR4,   1,OUDS,French Camp CG,White Mountain RD,9533,A05004,2,2006,5475,10757,552,0,16784,5475,10757,552,0,16784
504,DUR4,   1,OUDS,McGee Creek CG,White Mountain RD,9534,A05004,2,2006,910,2651,93,0,3654,910,2651,93,0,3654
504,DUR5,   1,OUDS,Aspen Group CG,White Mountain RD,9535,A05004,2,2006,32,56,0,0,88,32,56,0,0,88
504,DUR4,   1,OUDS,Iris Meadow CG,White Mountain RD,9536,A05004,2,2006,659,2877,3,0,3539,659,2877,3,0,3539
504,DUR4,   1,OUDS,Palisade  CG,White Mountain RD,9537,A05004,2,2006,12,1683,0,0,1695,12,1683,0,0,1695
504,DUR4,   1,OUDS,East Fork CG,White Mountain RD,9538,A05004,2,2006,3299,23357,366,0,27022,3299,23357,366,0,27022
504,DUR4,   1,OUDS,Tuff Campground,White Mountain RD,9539,A05004,2,2006,2419,4514,173,0,7106,2419,4514,173,0,7106
504,DUR4,   1,OUDS,Pine Grove CG,White Mountain RD,9540,A05004,2,2006,161,2360,36,0,2557,161,2360,36,0,2557
504,DUR4,   1,OUDS,Rock Creek Lake CG,White Mountain RD,9542,A05004,2,2006,561,6149,264,0,6974,561,6149,264,0,6974
504,DUR4,   1,OUDS,Mosquito Flat CG,White Mountain RD,9543,A05004,2,2006,45,55,10,0,110,45,55,10,0,110
504,DUR4,   1,OUDS,Big Trees CG,White Mountain RD,9544,A05004,2,2006,378,672,32,0,1082,378,672,32,0,1082
504,DUR4,   1,OUDS,Bishop Park CG,White Mountain RD,9545,A05004,2,2006,537,1345,145,0,2027,537,1345,145,0,2027
504,DUR4,   1,OUDS,North Lake CG,White Mountain RD,9546,A05004,2,2006,93,536,0,0,629,93,536,0,0,629
504,DUR4,   1,OUDS,Sabrina CG,White Mountain RD,9547,A05004,2,2006,444,1161,0,0,1605,444,1161,0,0,1605
504,DUR4,   1,OUDS,4 Jeffery CG,White Mountain RD,9548,A05004,2,2006,1376,3618,507,0,5501,1376,3618,507,0,5501
504,DUR4,   1,OUDS,Mountain Glen CG,White Mountain RD,9549,A05004,2,2006,58,150,0,0,208,58,150,0,0,208
504,DUR4,   1,OUDS,Willow CG,White Mountain RD,9551,A05004,2,2006,130,516,0,0,646,130,516,0,0,646
504,DUR4,   1,OUDS,Upper Sage Flat CG,White Mountain RD,9554,A05004,2,2006,609,1180,108,0,1897,609,1180,108,0,1897
504,DUR4,   1,OUDS,Big Pine Creek CG,White Mountain RD,9556,A05004,2,2006,664,1978,121,0,2763,664,1978,121,0,2763
504,DUR4,   1,OUDS,Forks Campground,White Mountain RD,9560,A05004,2,2006,190,281,56,0,527,190,281,56,0,527
504,DUR4,   1,OUDS,Intake 2 Upper CG,White Mountain RD,9562,A05004,2,2006,550,1098,250,0,1898,550,1098,250,0,1898
504,RE4,   1,OUDS,Rock Creek Lodge,White Mountain RD,9572,A05004,2,2006,0,0,0,0,0,0,0,0,0,0
504,RE4,   1,OUDS,Rock Creek Lakes Resort,White Mountain RD,9573,A05004,2,2006,264,0,98,0,362,264,0,98,0,362
504,RE4,   1,OUDS,Parcher's Resort,White Mountain RD,9576,A05004,2,2006,0,0,0,0,0,0,0,0,0,0
504,RE4,   1,OUDS,Glacier Lodge,White Mountain RD,9577,A05004,2,2006,200,531,75,0,806,200,531,75,0,806
504,DUR4,   1,OUDS,Sage Flat CG,White Mountain RD,9609,A05004,2,2006,728,1181,0,0,1909,728,1181,0,0,1909
504,DUR4,   1,OUDS,Intake 2 Walk in CG,White Mountain RD,9610,A05004,2,2006,0,0,0,0,0,0,0,0,0,0
504,DUR4,   1,OUDS,Upper Pine Grove CG,White Mountain RD,9612,A05004,2,2006,282,2006,58,0,2346,282,2006,58,0,2346
504,DUR5,   1,OUDS,Palisade/Clyde Group CG,White Mountain RD,9613,A05004,2,2006,10,33,0,0,43,10,33,0,0,43
504,DUR4,   1,OUDS,Grays Meadow CG,Mt Whitney Ranger District,9618,A05004,2,2006,3757,6278,3303,98,13436,3757,6278,3303,98,13436
504,DUR4,   1,OUDS,Onion Valley CG,Mt Whitney Ranger District,9620,A05004,2,2006,889,3600,1446,0,5935,889,3600,1446,0,5935
504,DUR4,   1,OUDS,Lone Pine CG,Mt Whitney Ranger District,9621,A05004,2,2006,2567,1459,409,0,4435,2567,1459,409,0,4435
504,DUR4,   1,OUDS,Whitney Portal CG,Mt Whitney Ranger District,9622,A05004,2,2006,3116,3235,400,0,6751,3116,3235,400,0,6751
504,DUR5,   1,OUDS,Bishop Park Group CG,Mt Whitney Ranger District,9624,A05004,2,2006,13,44,0,0,57,13,44,0,0,57
504,DUR5,   1,OUDS,Rock Creek Lake Group CG,Mt Whitney Ranger District,9625,A05004,2,2006,45,86,7,0,138,45,86,7,0,138
504,DUR5,   1,OUDS,Whitney Portal Group CG,Mt Whitney Ranger District,46053,A05004,2,2006,531,312,24,0,867,531,312,24,0,867
504,DUR4,   1,OUDS,Whitney Trailhead Walk-in CG,Mt Whitney Ranger District,46055,A05004,2,2006,93,856,58,0,1007,93,856,58,0,1007
515,DUR5,   1,OUDS,Dinkey Group CG,Kings River RD,96,A05015,2,2007,4,14,0,0,18,4,14,0,0,18
515,RE4,1,OUDS,Forks Resort Lodge,Mariposa RD,11909,A05015,2,2007,125,0,27,0,152,125,0,27,0,152
515,RE4,1,OUDS,Miller's Resort Lodge,Mariposa RD,11910,A05015,2,2007,0,1036,59,15,1110,0,1036,59,15,1110
515,DUR4,   1,OUDS,Catavee Campground,Pineridge RD,22423,A05015,2,2007,100,878,0,0,978,100,878,0,0,978
515,DUR4,   1,OUDS,Gigantea Campground,Kings River RD,22439,A05015,2,2007,66,115,0,0,181,66,115,0,0,181
515,NONE,   1,OUDS,Soda Springs Campground,Minarets RD,22903,A05015,2,2007,85,111,0,0,196,85,111,0,0,196
515,DUR5,   1,OUDS,Crane Valley Group CG,Mariposa RD,29531,A05015,2,2007,261,15,0,121,397,261,15,0,121,397
515,RE4,1,OUDS,Sierra Summit Lodge,Pineridge RD,11626,A05015,2,2007,229,58,642,2517,3446,229,58,642,2517,3446
515,RE4,1,OUDS,Lakeshore Resort Lodge,Pineridge RD,11627,A05015,2,2007,1258,3560,470,701,5989,1258,3560,470,701,5989
515,RE4,1,OUDS,Cedar Crest Lodge,Pineridge RD,11628,A05015,2,2007,0,0,0,0,0,0,0,0,0,0
515,RE4,1,OUDS,Huntington Lake Resort Lodge,Pineridge RD,11629,A05015,2,2007,0,0,0,0,0,0,0,0,0,0
515,RE4,1,OUDS,Lakeview Cottages,Pineridge RD,11630,A05015,2,2007,0,0,0,0,0,0,0,0,0,0
515,DUR4,   1,OUDS,Dinkey Creek Campground,Kings River RD,11680,A05015,2,2007,1762,4429,0,0,6191,1762,4429,0,0,6191
515,DUR4,   1,OUDS,Marmot Rock Campground,Kings River RD,11698,A05015,2,2007,19,107,0,0,126,19,107,0,0,126
515,DUR5,   1,OUDS,Kirch Flat Group CG,Kings River RD,11706,A05015,2,2007,11,4,2,1,18,11,4,2,1,18
515,RE4,1,OUDS,Dinkey Creek Resort Lodge,Kings River RD,11735,A05015,2,2007,0,0,100,0,100,0,0,100,0,100
515,DUR4,   1,OUDS,Wishon Village,Kings River RD,11737,A05015,2,2007,0,0,0,0,0,0,0,0,0,0
515,DUR4,   1,OUDS,Sweetwater Campground,Minarets RD,11759,A05015,2,2007,102,209,0,0,311,102,209,0,0,311
515,DUR4,   1,OUDS,Mammoth Pool CG,Minarets RD,11760,A05015,2,2007,267,515,0,0,782,267,515,0,0,782
515,DUR4,   1,OUDS,Trapper Springs Campground,Kings River RD,35107,A05015,2,2007,45,154,0,0,199,45,154,0,0,199
515,DUR4,   1,OUDS,Wagners Campground,Minarets RD,36139,A05015,2,2007,0,0,0,0,0,0,0,0,0,0
515,DUR4,   1,OUDS,Dirt Flat Campground,Mariposa RD,51504,A05015,2,2007,0,0,7,0,7,0,0,7,0,7
515,DUR4,   1,OUDS,Dry Gulch Campground,Mariposa RD,51505,A05015,2,2007,0,0,21,1,22,0,0,21,1,22
515,DUR4,   1,OUDS,Whiskers Campground,Minarets RD,34507,A05015,2,2007,0,0,0,0,0,0,0,0,0,0
515,SV1,   1,DUDS,Sierra Summit Winter Sports Area,Pineridge RD,30,A05015,2,2007,7672,118,18496,55927,82213,7672,118,18496,55927,82213
515,DUR5,   1,OUDS,Upper Kings Group CG,Kings River RD,91,A05015,2,2007,43,123,0,0,166,43,123,0,0,166
515,DUR5,   1,OUDS,Green Cabin Flat Group,Kings River RD,95,A05015,2,2007,0,0,0,0,0,0,0,0,0,0
515,DUR5,   1,OUDS,Spring Cove Campground,Mariposa RD,11878,A05015,2,2007,1276,2724,0,0,4000,1276,2724,0,0,4000
515,DUR5,   1,OUDS,Wishon Point Campground,Mariposa RD,11879,A05015,2,2007,930,1946,0,0,2876,930,1946,0,0,2876
515,DUR5,   1,OUDS,Chilkoot Campground,Mariposa RD,11880,A05015,2,2007,101,150,0,0,251,101,150,0,0,251
515,DUR5,   1,OUDS,Grey's Mountain Campground,Mariposa RD,11882,A05015,2,2007,237,500,0,0,737,237,500,0,0,737
515,DUR5,   1,OUDS,Soquel Campground,Mariposa RD,11883,A05015,2,2007,207,276,0,0,483,207,276,0,0,483
515,DUR4,   1,OUDS,Texas Flat Group CG,Mariposa RD,11884,A05015,2,2007,32,89,0,0,121,32,89,0,0,121
515,DUR4,   1,OUDS,Kelty Meadow Campground,Mariposa RD,11885,A05015,2,2007,93,226,0,0,319,93,226,0,0,319
515,DUR5,   1,OUDS,Summerdale Campground,Mariposa RD,11889,A05015,2,2007,1096,858,0,0,1954,1096,858,0,0,1954
515,DUR5,   1,OUDS,Big Sandy Campground,Mariposa RD,11891,A05015,2,2007,75,169,0,0,244,75,169,0,0,244
515,DUR5,   1,OUDS,Fresno Dome Campground,Mariposa RD,11893,A05015,2,2007,98,127,0,0,225,98,127,0,0,225
515,DUR5,   1,OUDS,Recreation Point Group CG,Mariposa RD,11898,A05015,2,2007,215,4,2,110,331,215,4,2,110,331
515,DUR4,   1,OUDS,Fish Creek Campground,Minarets RD,11587,A05015,2,2007,69,112,0,0,181,69,112,0,0,181
515,DUR5,   1,OUDS,Rock Creek Campground,Minarets RD,11588,A05015,2,2007,311,460,0,0,771,311,460,0,0,771
515,DUR4,   1,OUDS,Gaggs Creek Campground,Minarets RD,11590,A05015,2,2007,0,0,0,0,0,0,0,0,0,0
515,DUR4,   1,OUDS,Dorabelle Campground,Pineridge RD,11606,A05015,2,2007,838,3306,0,0,4144,838,3306,0,0,4144
515,DUR4,   1,OUDS,Swanson Meadow CG,Pineridge RD,11607,A05015,2,2007,83,262,0,0,345,83,262,0,0,345
515,DUR4,   1,OUDS,Rancheria Campground,Pineridge RD,11608,A05015,2,2007,1365,4547,0,0,5912,1365,4547,0,0,5912
515,DUR4,   1,OUDS,College Campground,Pineridge RD,11609,A05015,2,2007,141,501,0,0,642,141,501,0,0,642
515,DUR4,   1,OUDS,Deer Creek Campground,Pineridge RD,11610,A05015,2,2007,654,1229,0,0,1883,654,1229,0,0,1883
515,DUR4,   1,OUDS,Kinnikinnick Campground,Pineridge RD,11611,A05015,2,2007,144,933,0,0,1077,144,933,0,0,1077
515,DUR4,   1,OUDS,Upper Billy Creek CG,Pineridge RD,11612,A05015,2,2007,278,1205,0,0,1483,278,1205,0,0,1483
515,DUR4,   1,OUDS,Lower Billy Creek CG,Pineridge RD,11613,A05015,2,2007,238,474,0,0,712,238,474,0,0,712
515,DUR4,   1,OUDS,Lower Chiquito CG,Minarets RD,11775,A05015,2,2007,49,27,0,0,76,49,27,0,0,76
515,DUR4,   1,OUDS,Portal Forebay CG,Pineridge RD,11815,A05015,2,2007,9,42,0,0,51,9,42,0,0,51
515,DUR4,   1,OUDS,Ward Lake Campground,Pineridge RD,11816,A05015,2,2007,60,74,0,0,134,60,74,0,0,134
515,DUR4,   1,OUDS,Jackass Meadows Campground,Pineridge RD,11817,A05015,2,2007,61,248,0,0,309,61,248,0,0,309
515,DUR4,   1,OUDS,Mono Hot Springs CG,Pineridge RD,11823,A05015,2,2007,381,1174,0,0,1555,381,1174,0,0,1555
515,DUR4,   1,OUDS,Mono Creek Campground,Pineridge RD,11825,A05015,2,2007,33,26,0,0,59,33,26,0,0,59
515,DUR4,   1,OUDS,Vermillion Campground,Pineridge RD,11826,A05015,2,2007,250,870,0,0,1120,250,870,0,0,1120
515,RE4,1,OUDS,Mono Hot Springs Resort Lodge,Pineridge RD,11852,A05015,2,2007,0,0,0,0,0,0,0,0,0,0
515,RE4,1,OUDS,Vermillion Valley Resort Lodge,Pineridge RD,11853,A05015,2,2007,0,0,0,0,0,0,0,0,0,0
515,DUR5,   1,OUDS,Lupine/Cedar Campground,Mariposa RD,11876,A05015,2,2007,2258,4674,550,71,7553,2258,4674,550,71,7553
516,PTC3,   1,VIEWCORR,State Highway 108,Summit RD,163,A05016,2,2007,400400,404800,404800,396000,1606000,400400,404800,404800,396000,1606000
516,PTC3,   1,VIEWCORR,Route 4- Ebbetts Pass,Calaveras RD,164,A05016,2,2007,364000,368000,368000,360000,1460000,364000,368000,368000,360000,1460000
516,ST1,   1,DUDS,Bear Valley X Country,Calaveras RD,16,A05016,2,2007,360,0,1831,6873,9064,360,0,1831,6873,9064
516,DUR4,   1,OUDS,Pinecrest Campground,Summit RD,17,A05016,2,2007,6329,13198,332,0,19859,6329,13198,332,0,19859
516,DUR4,   1,OUDS,Meadowview Campground,Summit RD,18,A05016,2,2007,1984,4953,0,0,6937,1984,4953,0,0,6937
516,DUR4,   1,OUDS,Clark Fork Campground,Summit RD,19,A05016,2,2007,618,1143,120,0,1881,618,1143,120,0,1881
516,DUR4,   1,OUDS,Big Meadow Campground,Calaveras RD,20,A05016,2,2007,306,1163,0,0,1469,306,1163,0,0,1469
516,DUR4,   1,OUDS,Sand Flat Campground,Summit RD,21,A05016,2,2007,398,741,47,0,1186,398,741,47,0,1186
516,DUR4,   1,OUDS,Cherry Valley CG,Groveland RD,22,A05016,2,2007,445,638,126,0,1209,445,638,126,0,1209
516,DUR4,   1,OUDS,Lake Alpine Campground,Calaveras RD,23,A05016,2,2007,572,1649,0,0,2221,572,1649,0,0,2221
516,DUR4,   1,OUDS,Baker Campground,Summit RD,24,A05016,2,2007,473,1088,118,0,1679,473,1088,118,0,1679
516,DUR5,   1,OUDS,Pioneer Trail Group CG,Summit RD,26,A05016,2,2007,51,358,12,0,421,51,358,12,0,421
516,DUR4,   1,OUDS,Fraser Flat Campground,Mi-Wok RD,27,A05016,2,2007,475,896,141,0,1512,475,896,141,0,1512
516,FE4,   1,OUDS,Fence Creek Campground,Summit RD,28,A05016,2,2007,360,686,12,0,1058,360,686,12,0,1058
516,DUR4,   1,OUDS,"Dimond ""O"" Campground",Groveland RD,29,A05016,2,2007,729,383,54,0,1166,729,383,54,0,1166
516,NONE,   1,OUDS,Highland Lakes CG,Calaveras RD,30,A05016,2,2007,73,1466,35,0,1574,73,1466,35,0,1574
516,DUR4,   1,OUDS,Brightman Campground,Summit RD,31,A05016,2,2007,439,916,0,0,1355,439,916,0,0,1355
516,DUR4,   1,OUDS,Pine Marten Campground,Calaveras RD,32,A05016,2,2007,551,1754,0,0,2305,551,1754,0,0,2305
516,DUR4,   1,OUDS,Lodgepole Overflow CG,Calaveras RD,33,A05016,2,2007,8,284,0,0,292,8,284,0,0,292
516,DUR4,   1,OUDS,Dardanelle Campground,Summit RD,35,A05016,2,2007,471,1106,0,0,1577,471,1106,0,0,1577
516,DUR4,   1,OUDS,Eureka Valley CG,Summit RD,36,A05016,2,2007,461,986,0,0,1447,461,986,0,0,1447
516,DUR4,   1,OUDS,Silvertip Campground,Calaveras RD,37,A05016,2,2007,227,588,0,0,815,227,588,0,0,815
516,DUR4,   1,OUDS,The Pines CG - Proxy,Groveland RD,38,A05016,2,2007,147,113,0,0,260,147,113,0,0,260
516,DUR4,   1,OUDS,Silver Valley CG,Calaveras RD,39,A05016,2,2007,75,890,0,0,965,75,890,0,0,965
516,NONE,   1,OUDS,Bloomfield I Campground,Calaveras RD,40,A05016,2,2007,51,371,10,0,432,51,371,10,0,432
516,DUR4,   1,OUDS,Boulder Flat CG,Summit RD,41,A05016,2,2007,154,530,0,0,684,154,530,0,0,684
516,NONE,   1,OUDS,Hull Creek Campground,Mi-Wok RD,42,A05016,2,2007,545,1096,172,0,1813,545,1096,172,0,1813
516,DUR4,   1,OUDS,Deadman Campground,Summit RD,43,A05016,2,2007,297,506,0,0,803,297,506,0,0,803
516,FE4,   1,OUDS,Mill Creek Campground,Summit RD,44,A05016,2,2007,217,570,17,0,804,217,570,17,0,804
516,FE4,   1,OUDS,Cascade Creek CG,Summit RD,46,A05016,2,2007,175,343,6,0,524,175,343,6,0,524
516,DUR4,   1,OUDS,Clark Fork Equestrian CG,Summit RD,47,A05016,2,2007,40,185,84,0,309,40,185,84,0,309
516,DUR4,   1,OUDS,Sweetwater Campground,Groveland RD,48,A05016,2,2007,134,159,0,0,293,134,159,0,0,293
516,NONE,   1,OUDS,Mosquito Lakes CG,Calaveras RD,49,A05016,2,2007,82,462,13,0,557,82,462,13,0,557
516,FE4,   1,OUDS,Niagra Creek Campground,Summit RD,50,A05016,2,2007,131,256,8,0,395,131,256,8,0,395
516,FE4,   1,OUDS,Niagra OHV Campground,Summit RD,51,A05016,2,2007,112,286,3,0,401,112,286,3,0,401
516,DUR4,   1,OUDS,Lost Claim Campground,Groveland RD,52,A05016,2,2007,79,79,0,0,158,79,79,0,0,158
516,DUR5,   1,OUDS,Moore Creek Group CG,Groveland RD,53,A05016,2,2007,4,8,0,0,12,4,8,0,0,12
516,NONE,   1,OUDS,Hacienda Campground,Mi-Wok RD,55,A05016,2,2007,181,120,0,0,301,181,120,0,0,301
516,DUR4,   1,OUDS,Backpackers Campground,Calaveras RD,56,A05016,2,2007,0,72,0,0,72,0,72,0,0,72
516,DUR4,   1,OUDS,Pigeon Flat Campground,Summit RD,58,A05016,2,2007,89,260,0,0,349,89,260,0,0,349
516,DUR4,   1,OUDS,Wa Ka Luu Hep Yoo CG,Calaveras RD,59,A05016,2,2007,501,511,131,0,1143,501,511,131,0,1143
516,DUR4,   1,OUDS,Spicer Campground,Calaveras RD,60,A05016,2,2007,830,1973,45,0,2848,830,1973,45,0,2848
516,DUR5,   1,OUDS,Spicer Group Campground,Calaveras RD,61,A05016,2,2007,15,60,0,0,75,15,60,0,0,75
516,NONE,   1,OUDS,Sandbar Flat Campground,Mi-Wok RD,62,A05016,2,2007,316,480,69,0,865,316,480,69,0,865
516,NONE,   1,OUDS,Stanislaus River CG,Calaveras RD,63,A05016,2,2007,301,2023,51,0,2375,301,2023,51,0,2375
516,SV1,   1,DUDS,Dodge Ridge Ski Area,Summit RD,14,A05016,2,2007,444,0,28045,100582,129071,444,0,28045,100582,129071
516,ST1,   1,DUDS,Bear Valley Ski Area,Calaveras RD,15,A05016,2,2007,3670,0,15814,54563,74047,3670,0,15814,54563,74047
516,DUR5,   1,OUDS,Lodgepole Group CG,Calaveras RD,64,A05016,2,2007,8,14,0,0,22,8,14,0,0,22
516,DUR4,   1,OUDS,Pinecrest Chalet CG - RV Sites,Summit RD,65,A05016,2,2007,256,857,36,16,1165,256,857,36,16,1165
516,DUR4,   1,OUDS,Dardanelle Resort CG,Summit RD,66,A05016,2,2007,0,0,0,0,0,0,0,0,0,0
516,RE4,   1,OUDS,Pinecrest Lake Resort,Summit RD,67,A05016,2,2007,1038,1959,654,1219,4870,1038,1959,654,1219,4870
516,RE4,   1,OUDS,Pinecrest Lake Chalet Cabins,Summit RD,68,A05016,2,2007,573,1429,403,1009,3414,573,1429,403,1009,3414
516,RE4,   1,OUDS,Dardanelle Resort,Summit RD,69,A05016,2,2007,0,0,0,0,0,0,0,0,0,0
516,RE4,   1,OUDS,Lake Alpine Lodge,Calaveras RD,70,A05016,2,2007,283,794,62,0,1139,283,794,62,0,1139
504,DUR4,1,OUDS,Lower Lee Vining CG,Mono Ranger District,239659,A05004,3,2011,2000,7500,950,0,10450,2000,7500,950,0,10450
504,DUR4,1,OUDS,Morraine CG,Mono Ranger District,239656,A05004,3,2011,0,3500,0,0,3500,0,3500,0,0,3500
504,DUR4,1,OUDS,Hartley Springs CG,Mono Ranger District,239660,A05004,3,2011,0,0,0,0,0,0,0,0,0,0
504,DUR5,1,OUDS,Furgison Group CG,White Mountain Ranger District,239652,A05004,3,2011,0,6,0,0,6,0,6,0,0,6
504,DUR5,1,DUDS,Trailhead Group CG (Saddlebag Lk),Mono Ranger District,239661,A05004,3,2011,0,157,0,0,157,0,157,0,0,157
504,DUR4,1,OUDS,Bitterbrush CG - proxy,White Mountain Ranger District,239664,A05004,3,2011,725,1463,192,0,2380,725,1463,192,0,2380
504,DUR4,1,OUDS,Sabrina CG,White Mountain Ranger District,9547,A05004,3,2011,1454,5562,0,0,7016,1454,5562,0,0,7016
504,DUR4,1,OUDS,4 Jeffery CG,White Mountain Ranger District,9548,A05004,3,2011,10503,16101,1701,0,28305,10503,16101,1701,0,28305
504,DUR4,1,OUDS,Mountain Glen CG,White Mountain Ranger District,9549,A05004,3,2011,207,477,0,0,684,207,477,0,0,684
504,DUR4,1,OUDS,Willow CG,White Mountain Ranger District,9551,A05004,3,2011,365,1404,0,0,1769,365,1404,0,0,1769
504,DUR4,1,OUDS,Upper Sage Flat CG,White Mountain Ranger District,9554,A05004,3,2011,2282,972,594,0,3848,2282,972,594,0,3848
504,DUR4,1,OUDS,Big Pine Creek CG,White Mountain Ranger District,9556,A05004,3,2011,2367,8429,332,0,11128,2367,8429,332,0,11128
504,DUR4,1,OUDS,Forks Campground,White Mountain Ranger District,9560,A05004,3,2011,958,3137,531,0,4626,958,3137,531,0,4626
504,DUR4,1,OUDS,Intake 2 Upper CG,White Mountain Ranger District,9562,A05004,3,2011,2552,1065,860,0,4477,2552,1065,860,0,4477
504,RE4,1,OUDS,Rock Creek Lodge,White Mountain Ranger District,9572,A05004,3,2011,1600,7200,2000,3500,14300,1600,7200,2000,3500,14300
504,RE4,1,OUDS,Rock Creek Lakes Resort,White Mountain Ranger District,9573,A05004,3,2011,137,632,50,0,819,137,632,50,0,819
504,RE4,1,OUDS,Parcher's Resort,White Mountain Ranger District,9576,A05004,3,2011,524,0,266,0,790,524,0,266,0,790
504,RE4,1,OUDS,Glacier Lodge,White Mountain Ranger District,9577,A05004,3,2011,0,0,0,0,0,0,0,0,0,0
504,DUR4,1,OUDS,Sage Flat CG,White Mountain Ranger District,9609,A05004,3,2011,2975,6179,167,0,9321,2975,6179,167,0,9321
504,DUR4,1,OUDS,Intake 2 Walk in CG,White Mountain Ranger District,9610,A05004,3,2011,0,0,0,0,0,0,0,0,0,0
504,DUR4,1,OUDS,Upper Pine Grove CG,White Mountain Ranger District,9612,A05004,3,2011,195,762,0,0,957,195,762,0,0,957
504,DUR5,1,OUDS,Palisade/Clyde Group CG,White Mountain Ranger District,9613,A05004,3,2011,0,0,0,0,0,0,0,0,0,0
504,DUR4,1,OUDS,Grays Meadow CG,Mt Whitney Ranger District,9618,A05004,3,2011,2024,244,5,1126,3399,2024,244,5,1126,3399
504,DUR4,1,OUDS,Onion Valley CG,Mt Whitney Ranger District,9620,A05004,3,2011,1030,0,0,96,1126,1030,0,0,96,1126
504,DUR4,1,OUDS,Lone Pine CG,Mt Whitney Ranger District,9621,A05004,3,2011,1523,190,0,792,2505,1523,190,0,792,2505
504,DUR4,1,OUDS,Whitney Portal CG,Mt Whitney Ranger District,9622,A05004,3,2011,3483,334,0,892,4709,3483,334,0,892,4709
504,DUR5,1,OUDS,Bishop Park Group CG,Mt Whitney Ranger District,9624,A05004,3,2011,0,100,0,0,100,0,100,0,0,100
504,DUR5,1,OUDS,Rock Creek Lake Group CG,Mt Whitney Ranger District,9625,A05004,3,2011,94,0,0,0,94,94,0,0,0,94
504,RE4,1,OUDS,Mammoth Mountain Inn,Mammoth Ranger District,9325,A05004,3,2011,12201,11395,7445,14575,45616,12201,11395,7445,14575,45616
504,DUR4,1,OUDS,Tioga Lake CG,Mono Ranger District,9343,A05004,3,2011,0,2272,105,0,2377,0,2272,105,0,2377
504,DUR4,1,OUDS,Big Bend CG,Mono Ranger District,9345,A05004,3,2011,623,3752,321,0,4696,623,3752,321,0,4696
504,DUR4,1,OUDS,Sawmill Walk-in CG,Mono Ranger District,9347,A05004,3,2011,0,1313,21,0,1334,0,1313,21,0,1334
504,DUR4,1,OUDS,Saddlebag Lake CG,Mono Ranger District,9348,A05004,3,2011,0,2406,65,0,2471,0,2406,65,0,2471
504,DUR4,1,OUDS,Ellery Lake CG,Mono Ranger District,9349,A05004,3,2011,0,2562,0,0,2562,0,2562,0,0,2562
504,DUR4,1,OUDS,Silver Lake CG,Mono Ranger District,9356,A05004,3,2011,6429,16240,1871,0,24540,6429,16240,1871,0,24540
504,DUR4,1,OUDS,Reversed Creek CG,Mono Ranger District,9360,A05004,3,2011,1122,3010,70,0,4202,1122,3010,70,0,4202
504,DUR4,1,OUDS,Gull Lake CG,Mono Ranger District,9361,A05004,3,2011,1077,2432,312,0,3821,1077,2432,312,0,3821
504,DUR4,1,OUDS,June Lake CG,Mono Ranger District,9362,A05004,3,2011,2784,7647,487,0,10918,2784,7647,487,0,10918
504,DUR4,1,OUDS,Pine Cliff Trailer Park,Mono Ranger District,9363,A05004,3,2011,0,0,0,0,0,0,0,0,0,0
504,RE4,1,OUDS,Tioga Pass Resort,Mono Ranger District,9366,A05004,3,2011,0,0,0,0,0,0,0,0,0,0
504,RE4,1,OUDS,Silver Lake Resort Cabins,Mono Ranger District,9367,A05004,3,2011,185,304,65,0,554,185,304,65,0,554
504,RE4,1,OUDS,Big Rock Landing Resort,Mono Ranger District,9371,A05004,3,2011,307,634,247,150,1338,307,634,247,150,1338
504,RE4,1,OUDS,Boulder Lodge,Mono Ranger District,9372,A05004,3,2011,2530,7701,874,773,11878,2530,7701,874,773,11878
504,DUR4,1,OUDS,Grant Lake Marina,Mono Ranger District,9381,A05004,3,2011,1905,4434,50,0,6389,1905,4434,50,0,6389
504,SV1,1,DUDS,June Mountain Ski Area,Mono Ranger District,9384,A05004,3,2011,8529,4516,15551,46224,74820,8529,4516,15551,46224,74820
504,DUR4,1,OUDS,Oh! Ridge CG,Mono Ranger District,9393,A05004,3,2011,5476,24230,826,0,30532,5476,24230,826,0,30532
504,DUR4,1,OUDS,Old Shady Rest CG,Mammoth Ranger District,9428,A05004,3,2011,1974,8927,0,0,10901,1974,8927,0,0,10901
504,DUR4,1,OUDS,Agnew Meadows CG,Mammoth Ranger District,9432,A05004,3,2011,0,1415,0,0,1415,0,1415,0,0,1415
504,DUR4,1,OUDS,Upper Soda Springs CG,Mammoth Ranger District,9433,A05004,3,2011,0,3569,0,0,3569,0,3569,0,0,3569
504,DUR4,1,OUDS,Pumice Flat CG,Mammoth Ranger District,9434,A05004,3,2011,0,2722,0,0,2722,0,2722,0,0,2722
504,DUR4,1,OUDS,Minaret Falls CG,Mammoth Ranger District,9435,A05004,3,2011,0,3798,0,0,3798,0,3798,0,0,3798
504,DUR4,1,OUDS,Reds Meadow CG,Mammoth Ranger District,9436,A05004,3,2011,0,9392,157,0,9549,0,9392,157,0,9549
504,DUR4,1,OUDS,Twin Lakes CG,Mammoth Ranger District,9439,A05004,3,2011,511,23402,566,0,24479,511,23402,566,0,24479
504,DUR4,1,OUDS,Coldwater CG,Mammoth Ranger District,9440,A05004,3,2011,0,13820,55,0,13875,0,13820,55,0,13875
504,DUR4,1,OUDS,Lake George CG,Mammoth Ranger District,9441,A05004,3,2011,0,2477,0,0,2477,0,2477,0,0,2477
504,DUR4,1,OUDS,Lake Mary CG,Mammoth Ranger District,9442,A05004,3,2011,0,9757,0,0,9757,0,9757,0,0,9757
504,DUR4,1,OUDS,Pine City CG,Mammoth Ranger District,9443,A05004,3,2011,0,1935,0,0,1935,0,1935,0,0,1935
504,DUR4,1,OUDS,Sherwin Creek CG,Mammoth Ranger District,9444,A05004,3,2011,4020,13622,0,0,17642,4020,13622,0,0,17642
504,DUR4,1,OUDS,Convict Lake CG,Mammoth Ranger District,9445,A05004,3,2011,5881,931,0,2748,9560,5881,931,0,2748,9560
504,DUR5,1,OUDS,Agnew Meadows Group CG,Mammoth Ranger District,9448,A05004,3,2011,0,97,0,0,97,0,97,0,0,97
504,DUR5,1,OUDS,Pumice Flat Group CG,Mammoth Ranger District,9449,A05004,3,2011,0,131,0,0,131,0,131,0,0,131
504,DUR4,1,OUDS,New Shady Rest CG,Mammoth Ranger District,9464,A05004,3,2011,3516,16115,647,0,20278,3516,16115,647,0,20278
504,DUR5,1,OUDS,Pine Glen Group CG,Mammoth Ranger District,9465,A05004,3,2011,135,369,0,0,504,135,369,0,0,504
504,RE4,1,OUDS,Woods Lodge,Mammoth Ranger District,9468,A05004,3,2011,963,5778,528,0,7269,963,5778,528,0,7269
504,RE4,1,OUDS,Wildyrie Lodge,Mammoth Ranger District,9469,A05004,3,2011,86,1539,0,0,1625,86,1539,0,0,1625
504,RE4,1,OUDS,Tamarack Lodge,Mammoth Ranger District,9470,A05004,3,2011,1391,2961,1499,2065,7916,1391,2961,1499,2065,7916
504,RE4,1,OUDS,Crystal Crag Lodge,Mammoth Ranger District,9471,A05004,3,2011,1745,8891,398,0,11034,1745,8891,398,0,11034
504,RE4,1,OUDS,Convict Lake Resort,Mammoth Ranger District,9472,A05004,3,2011,5230,7550,3760,2800,19340,5230,7550,3760,2800,19340
504,RE4,1,OUDS,Reds Meadow Resort,Mammoth Ranger District,9480,A05004,3,2011,0,0,0,0,0,0,0,0,0,0
504,SV1,1,DUDS,Mammoth Mt. Ski Area Winter,Mammoth Ranger District,9497,A05004,3,2011,262235,0,279168,728604,1270007,262235,0,279168,728604,1270007
504,DUR4,1,OUDS,Mammoth Mtn RV Park,Mammoth Ranger District,9514,A05004,3,2011,0,0,2831,3403,6234,0,0,2831,3403,6234
504,SV1,1,DUDS,Tamarack Nordic Ski,Mammoth Ranger District,9522,A05004,3,2011,1419,0,3278,9477,14174,1419,0,3278,9477,14174
504,DUR4,1,OUDS,Big Meadow CG,White Mountain Ranger District,9532,A05004,3,2011,1128,146,0,523,1797,1128,146,0,523,1797
504,DUR4,1,OUDS,French Camp CG,White Mountain Ranger District,9533,A05004,3,2011,2515,150,0,963,3628,2515,150,0,963,3628
504,DUR4,1,OUDS,McGee Creek CG,White Mountain Ranger District,9534,A05004,3,2011,1266,25,0,160,1451,1266,25,0,160,1451
504,DUR5,1,OUDS,Aspen Group CG,White Mountain Ranger District,9535,A05004,3,2011,4,0,0,0,4,4,0,0,0,4
504,DUR4,1,OUDS,Iris Meadow CG,White Mountain Ranger District,9536,A05004,3,2011,1158,181,0,489,1828,1158,181,0,489,1828
504,DUR4,1,OUDS,Palisade  CG,White Mountain Ranger District,9537,A05004,3,2011,249,0,0,98,347,249,0,0,98,347
504,DUR4,1,OUDS,East Fork CG,White Mountain Ranger District,9538,A05004,3,2011,6043,256,0,907,7206,6043,256,0,907,7206
504,DUR4,1,OUDS,Tuff Campground,White Mountain Ranger District,9539,A05004,3,2011,2562,125,0,824,3511,2562,125,0,824,3511
504,DUR4,1,OUDS,Lower Pine Grove CG,White Mountain Ranger District,9540,A05004,3,2011,3126,105,0,128,3359,3126,105,0,128,3359
504,DUR4,1,OUDS,Rock Creek Lake CG,White Mountain Ranger District,9542,A05004,3,2011,2251,164,0,320,2735,2251,164,0,320,2735
504,DUR4,1,OUDS,Mosquito Flat CG,White Mountain Ranger District,9543,A05004,3,2011,0,0,0,0,0,0,0,0,0,0
504,DUR4,1,OUDS,Big Trees CG,White Mountain Ranger District,9544,A05004,3,2011,1539,4541,324,0,6404,1539,4541,324,0,6404
504,DUR4,1,OUDS,Bishop Park CG,White Mountain Ranger District,9545,A05004,3,2011,1805,5445,237,0,7487,1805,5445,237,0,7487
504,DUR4,1,OUDS,North Lake CG,White Mountain Ranger District,9546,A05004,3,2011,401,2516,0,0,2917,401,2516,0,0,2917
504,DUR4,1,OUDS,Silver Lake Resort RV Park,Mono Ranger District,114,A05004,3,2011,393,768,152,0,1313,393,768,152,0,1313
504,FR1,1,DUDS,Mammoth Mtn. Ski Area Summer,Mammoth Ranger District,13,A05004,3,2011,908,76600,0,0,77508,908,76600,0,0,77508
504,RE4,1,OUDS,Tom's Place Resort,White Mountain Ranger District,130,A05004,3,2011,25491,42214,15348,9520,92573,25491,42214,15348,9520,92573
504,DUR5,1,OUDS,Whitney Portal Group CG,Mt Whitney Ranger District,46053,A05004,3,2011,213,12,0,42,267,213,12,0,42,267
504,DUR4,1,OUDS,Whitney Trailhead Walk-in CG,Mt Whitney Ranger District,46055,A05004,3,2011,344,28,0,55,427,344,28,0,55,427
504,DUR5,1,OUDS,Table Mountain Group CG,White Mountain Ranger District,66,A05004,3,2011,0,0,0,0,0,0,0,0,0,0
504,DUR5,1,OUDS,Nelson Group CG,White Mountain Ranger District,239654,A05004,3,2011,0,13,0,0,13,0,13,0,0,13
504,DUR5,1,OUDS,Obsidian Flat Group CG,Mono Ranger District,239663,A05004,3,2011,0,0,0,0,0,0,0,0,0,0
504,DUR5,1,OUDS,Norine Group CG,White Mountain Ranger District,239653,A05004,3,2011,0,6,0,0,6,0,6,0,0,6
504,DUR4,1,OUDS,Aspen CG,Mono Ranger District,239658,A05004,3,2011,1500,7000,250,0,8750,1500,7000,250,0,8750
515,DUR4,1,OUDS,Dinkey Creek Campground,High Sierra Ranger District,11680,A05015,3,2012,2414,5791,0,0,8205,2414,5791,0,0,8205
515,DUR4,1,OUDS,Buck Meadow Campground,High Sierra Ranger District,11682,A05015,3,2012,134,162,0,0,296,134,162,0,0,296
515,DUR4,1,OUDS,Marmot Rock Campground,High Sierra Ranger District,11698,A05015,3,2012,234,556,0,0,790,234,556,0,0,790
515,DUR4,1,OUDS,Sweetwater CG,Bass Lake Ranger District,11759,A05015,3,2012,59,274,0,0,333,59,274,0,0,333
515,DUR4,1,OUDS,Mammoth Pool CG,Bass Lake Ranger District,11760,A05015,3,2012,134,607,0,0,741,134,607,0,0,741
515,DUR4,1,OUDS,Lower Chiquito CG,Bass Lake Ranger District,11775,A05015,3,2012,59,110,0,0,169,59,110,0,0,169
515,DUR4,1,OUDS,Portal Forebay CG,High Sierra Ranger District,11815,A05015,3,2012,51,190,0,0,241,51,190,0,0,241
515,DUR4,1,OUDS,Ward Lake Campground,High Sierra Ranger District,11816,A05015,3,2012,58,230,0,0,288,58,230,0,0,288
515,DUR4,1,OUDS,Jackass Meadows Campground,High Sierra Ranger District,11817,A05015,3,2012,101,1999,0,0,2100,101,1999,0,0,2100
515,DUR4,1,OUDS,Mono Hot Springs CG,High Sierra Ranger District,11823,A05015,3,2012,472,1148,0,0,1620,472,1148,0,0,1620
515,DUR4,1,OUDS,Catavee Campground,High Sierra Ranger District,22423,A05015,3,2012,301,1188,0,0,1489,301,1188,0,0,1489
515,DUR4,1,OUDS,Gigantea Campground,High Sierra Ranger District,22439,A05015,3,2012,46,152,0,0,198,46,152,0,0,198
515,DUR4,1,OUDS,Mono Creek Campground,High Sierra Ranger District,11825,A05015,3,2012,50,198,0,0,248,50,198,0,0,248
515,DUR4,1,OUDS,Vermillion Campground,High Sierra Ranger District,11826,A05015,3,2012,283,783,0,0,1066,283,783,0,0,1066
515,DUR4,1,OUDS,Lupine/Cedar CG,Bass Lake Ranger District,11876,A05015,3,2012,1599,4903,372,0,6874,1599,4903,372,0,6874
515,DUR4,1,OUDS,Spring Cove CG,Bass Lake Ranger District,11878,A05015,3,2012,1154,3641,0,0,4795,1154,3641,0,0,4795
515,DUR4,1,OUDS,Wishon Point CG,Bass Lake Ranger District,11879,A05015,3,2012,1149,2923,0,0,4072,1149,2923,0,0,4072
515,DUR4,1,OUDS,Chilkoot CG,Bass Lake Ranger District,11880,A05015,3,2012,148,416,0,0,564,148,416,0,0,564
515,DUR4,1,OUDS,Grey's Mountain CG,Bass Lake Ranger District,11882,A05015,3,2012,132,441,0,0,573,132,441,0,0,573
515,DUR4,1,OUDS,Soquel CG,Bass Lake Ranger District,11883,A05015,3,2012,183,387,0,0,570,183,387,0,0,570
515,DUR5,1,OUDS,Texas Flat Group CG,Bass Lake Ranger District,11884,A05015,3,2012,19,92,0,0,111,19,92,0,0,111
515,DUR4,1,OUDS,Kelty Meadow CG,Bass Lake Ranger District,11885,A05015,3,2012,66,187,0,0,253,66,187,0,0,253
515,DUR4,1,OUDS,Summerdale CG,Bass Lake Ranger District,11889,A05015,3,2012,1139,1774,208,0,3121,1139,1774,208,0,3121
515,DUR4,1,OUDS,Big Sandy CG,Bass Lake Ranger District,11891,A05015,3,2012,110,269,0,0,379,110,269,0,0,379
515,DUR4,1,OUDS,Soda Springs CG,Bass Lake Ranger District,22903,A05015,3,2012,100,136,0,0,236,100,136,0,0,236
515,DUR4,1,OUDS,Fish Creek CG,Bass Lake Ranger District,11587,A05015,3,2012,66,103,0,0,169,66,103,0,0,169
515,DUR4,1,OUDS,Rock Creek CG,Bass Lake Ranger District,11588,A05015,3,2012,196,522,0,0,718,196,522,0,0,718
515,DUR4,1,OUDS,Fresno Dome Campground,Bass Lake Ranger District,11893,A05015,3,2012,60,150,0,0,210,60,150,0,0,210
515,DUR5,1,OUDS,Recreation Point Group CG,Bass Lake Ranger District,11898,A05015,3,2012,108,258,2,0,368,108,258,2,0,368
515,RE4,1,OUDS,Forks Resort Lodge,Bass Lake Ranger District,11909,A05015,3,2012,395,882,26,0,1303,395,882,26,0,1303
515,RE4,1,OUDS,Miller's Resort Lodge,Bass Lake Ranger District,11910,A05015,3,2012,38,460,116,0,614,38,460,116,0,614
515,DUR5,1,OUDS,Crane Valley Group CG,Bass Lake Ranger District,29531,A05015,3,2012,106,282,3,0,391,106,282,3,0,391
515,SV1,1,DUDS,China Peak Mountain Resort,High Sierra Ranger District,30,A05015,3,2012,12914,0,14464,64502,91880,12914,0,14464,64502,91880
515,DUR4,1,OUDS,Whiskers CG,Bass Lake Ranger District,34507,A05015,3,2012,7,57,0,0,64,7,57,0,0,64
515,DUR4,1,OUDS,Trapper Springs Campground,High Sierra Ranger District,35107,A05015,3,2012,190,1242,0,0,1432,190,1242,0,0,1432
515,DUR4,1,OUDS,Dirt Flat CG,Bass Lake Ranger District,51504,A05015,3,2012,265,301,48,0,614,265,301,48,0,614
515,DUR4,1,OUDS,Dry Gulch CG,Bass Lake Ranger District,51505,A05015,3,2012,278,321,31,0,630,278,321,31,0,630
515,DUR4,1,OUDS,Gaggs Creek CG,Bass Lake Ranger District,11590,A05015,3,2012,34,84,0,0,118,34,84,0,0,118
515,DUR4,1,OUDS,Dorabelle Campground,High Sierra Ranger District,11606,A05015,3,2012,353,3191,0,0,3544,353,3191,0,0,3544
515,DUR4,1,OUDS,Swanson Meadow CG,High Sierra Ranger District,11607,A05015,3,2012,62,272,0,0,334,62,272,0,0,334
515,DUR4,1,OUDS,Rancheria Campground,High Sierra Ranger District,11608,A05015,3,2012,0,388,0,0,388,0,388,0,0,388
515,DUR4,1,OUDS,College Campground,High Sierra Ranger District,11609,A05015,3,2012,125,325,0,0,450,125,325,0,0,450
515,DUR4,1,OUDS,Deer Creek Campground,High Sierra Ranger District,11610,A05015,3,2012,823,1813,0,0,2636,823,1813,0,0,2636
515,DUR4,1,OUDS,Kinnikinnick Campground,High Sierra Ranger District,11611,A05015,3,2012,305,1249,0,0,1554,305,1249,0,0,1554
515,DUR4,1,OUDS,Upper Billy Creek CG,High Sierra Ranger District,11612,A05015,3,2012,382,1668,0,0,2050,382,1668,0,0,2050
515,DUR4,1,OUDS,Lower Billy Creek CG,High Sierra Ranger District,11613,A05015,3,2012,272,742,0,0,1014,272,742,0,0,1014
515,DUR4,1,OUDS,Badger Flat Family CG,High Sierra Ranger District,11619,A05015,3,2012,36,192,0,0,228,36,192,0,0,228
515,RE4,1,OUDS,China Peak Lodge,High Sierra Ranger District,11626,A05015,3,2012,539,823,444,1795,3601,539,823,444,1795,3601
515,RE4,1,OUDS,Huntington Lake Resort Lodge,High Sierra Ranger District,11629,A05015,3,2012,0,0,0,0,0,0,0,0,0,0
515,DUR5,1,OUDS,Upper Kings Group CG,High Sierra Ranger District,91,A05015,3,2012,0,23,0,0,23,0,23,0,0,23
515,DUR5,1,OUDS,Dinkey Group CG,High Sierra Ranger District,96,A05015,3,2012,10,41,0,0,51,10,41,0,0,51
515,DUR4,1,OUDS,Placer CG,Bass Lake Ranger District,11758,A05015,3,2012,20,58,0,0,78,20,58,0,0,78
515,DUR4,1,OUDS,Forks CG,Bass Lake Ranger District,11875,A05015,3,2012,1069,1844,3,0,2916,1069,1844,3,0,2916
516,DUR4,1,OUDS,Pinecrest Campground,Summit Ranger District,17,A05016,3,2012,7016,14335,376,0,21727,7016,14335,376,0,21727
516,DUR4,1,OUDS,Meadowview Campground,Summit Ranger District,18,A05016,3,2012,1681,4748,0,0,6429,1681,4748,0,0,6429
516,DUR4,1,OUDS,Clark Fork Campground,Summit Ranger District,19,A05016,3,2012,1040,3454,0,0,4494,1040,3454,0,0,4494
516,DUR4,1,OUDS,Big Meadow Campground,Calaveras Ranger District,20,A05016,3,2012,260,1062,0,0,1322,260,1062,0,0,1322
516,DUR4,1,OUDS,Sand Flat Campground,Summit Ranger District,21,A05016,3,2012,709,2096,0,0,2805,709,2096,0,0,2805
516,DUR4,1,OUDS,Cherry Valley CG,Groveland Ranger District,22,A05016,3,2012,565,1204,0,0,1769,565,1204,0,0,1769
516,DUR4,1,OUDS,Lake Alpine Campground,Calaveras Ranger District,23,A05016,3,2012,482,1711,0,0,2193,482,1711,0,0,2193
516,DUR4,1,OUDS,Baker Campground,Summit Ranger District,24,A05016,3,2012,944,2726,0,0,3670,944,2726,0,0,3670
516,DUR5,1,OUDS,Pioneer Trail Group CG,Summit Ranger District,26,A05016,3,2012,67,143,0,0,210,67,143,0,0,210
516,DUR4,1,OUDS,Fraser Flat Campground,Mi-Wok Ranger District,27,A05016,3,2012,1168,1988,68,0,3224,1168,1988,68,0,3224
516,DUR4,1,OUDS,Fence Creek Campground,Summit Ranger District,28,A05016,3,2012,185,646,9,0,840,185,646,9,0,840
516,DUR4,1,OUDS,"Dimond ""O"" Campground",Groveland Ranger District,29,A05016,3,2012,685,959,154,0,1798,685,959,154,0,1798
516,DUR4,1,OUDS,Brightman Campground,Summit Ranger District,31,A05016,3,2012,550,1027,121,0,1698,550,1027,121,0,1698
516,DUR4,1,OUDS,Pine Marten Campground,Calaveras Ranger District,32,A05016,3,2012,441,1985,0,0,2426,441,1985,0,0,2426
516,DUR4,1,OUDS,Lodgepole Overflow CG,Calaveras Ranger District,33,A05016,3,2012,0,246,0,0,246,0,246,0,0,246
516,DUR4,1,OUDS,Dardanelle Campground,Summit Ranger District,35,A05016,3,2012,406,832,1,0,1239,406,832,1,0,1239
516,DUR4,1,OUDS,Eureka Valley CG,Summit Ranger District,36,A05016,3,2012,415,949,43,0,1407,415,949,43,0,1407
516,DUR4,1,OUDS,Silvertip Campground,Calaveras Ranger District,37,A05016,3,2012,82,723,0,0,805,82,723,0,0,805
516,DUR4,1,OUDS,The Pines Campground,Groveland Ranger District,38,A05016,3,2012,259,430,8,0,697,259,430,8,0,697
516,DUR4,1,OUDS,Silver Valley CG,Calaveras Ranger District,39,A05016,3,2012,53,460,0,0,513,53,460,0,0,513
516,DUR4,1,OUDS,Boulder Flat CG,Summit Ranger District,41,A05016,3,2012,173,327,0,0,500,173,327,0,0,500
516,DUR4,1,OUDS,Deadman Campground,Summit Ranger District,43,A05016,3,2012,542,1329,0,0,1871,542,1329,0,0,1871
516,DUR4,1,OUDS,Mill Creek Campground,Summit Ranger District,44,A05016,3,2012,94,453,0,0,547,94,453,0,0,547
516,DUR4,1,OUDS,Cascade Creek CG,Summit Ranger District,46,A05016,3,2012,48,306,0,0,354,48,306,0,0,354
516,DUR4,1,OUDS,Clark Fork Equestrian CG,Summit Ranger District,47,A05016,3,2012,0,52,0,0,52,0,52,0,0,52
516,DUR4,1,OUDS,Sweetwater Campground,Groveland Ranger District,48,A05016,3,2012,1103,1341,24,0,2468,1103,1341,24,0,2468
516,DUR4,1,OUDS,Niagra Creek Campground,Summit Ranger District,50,A05016,3,2012,48,249,0,0,297,48,249,0,0,297
516,DUR4,1,OUDS,Niagra OHV Campground,Summit Ranger District,51,A05016,3,2012,52,192,8,0,252,52,192,8,0,252
516,DUR4,1,OUDS,Lost Claim Campground,Groveland Ranger District,52,A05016,3,2012,215,258,0,0,473,215,258,0,0,473
516,SV1,1,DUDS,Dodge Ridge Ski Area,Summit Ranger District,14,A05016,3,2012,7917,0,0,50562,58479,7917,0,0,50562,58479
516,ST1,1,DUDS,Bear Valley Ski Area,Calaveras Ranger District,15,A05016,3,2012,4588,0,7583,22597,34768,4588,0,7583,22597,34768
516,DUR4,1,OUDS,Backpackers Campground,Calaveras Ranger District,56,A05016,3,2012,10,95,0,0,105,10,95,0,0,105
516,DUR4,1,OUDS,Pigeon Flat Campground,Summit Ranger District,58,A05016,3,2012,82,183,7,0,272,82,183,7,0,272
516,DUR4,1,OUDS,Wa Ka Luu Hep Yoo CG,Calaveras Ranger District,59,A05016,3,2012,256,1350,93,0,1699,256,1350,93,0,1699
516,DUR4,1,OUDS,Spicer Campground,Calaveras Ranger District,60,A05016,3,2012,748,2149,50,0,2947,748,2149,50,0,2947
516,DUR5,1,OUDS,Spicer Group Campground,Calaveras Ranger District,61,A05016,3,2012,19,66,2,0,87,19,66,2,0,87
516,DUR5,1,OUDS,Lodgepole Group CG,Calaveras Ranger District,64,A05016,3,2012,12,46,0,0,58,12,46,0,0,58
516,DUR4,1,OUDS,Pinecrest Chalet CG - RV Sites,Summit Ranger District,65,A05016,3,2012,182,539,57,0,778,182,539,57,0,778
516,DUR4,1,OUDS,Dardanelle Resort CG,Summit Ranger District,66,A05016,3,2012,665,2130,0,0,2795,665,2130,0,0,2795
516,RE4,1,OUDS,Pinecrest Lake Resort,Summit Ranger District,67,A05016,3,2012,1043,2067,830,536,4476,1043,2067,830,536,4476
516,RE4,1,OUDS,Pinecrest Lake Chalet Cabins,Summit Ranger District,68,A05016,3,2012,645,1324,499,614,3082,645,1324,499,614,3082
516,RE4,1,OUDS,Dardanelle Resort,Summit Ranger District,69,A05016,3,2012,129,427,0,0,556,129,427,0,0,556
516,RE4,1,OUDS,Lake Alpine Lodge,Calaveras Ranger District,70,A05016,3,2012,128,663,26,0,817,128,663,26,0,817
516,ST1,1,DUDS,Bear Valley X Country,Calaveras Ranger District,16,A05016,3,2012,668,0,0,3193,3861,668,0,0,3193,3861
516,PTC3,1,VIEWCORR,State Highway 108,Summit Ranger District,163,A05016,3,2012,400400,404800,404800,396000,1606000,400400,404800,404800,396000,1606000
516,PTC3,1,VIEWCORR,Route 4- Ebbetts Pass,Calaveras Ranger District,164,A05016,3,2012,364000,368000,368000,360000,1460000,364000,368000,368000,360000,1460000
504,RE4,1,OUDS,Mammoth Mountain Inn,Mammoth Ranger District,9325,A05004,4,2016,11501,14348,8137,15346,49332,11501,14348,8137,15346,49332
504,DUR4,1,OUDS,Tioga Lake CG,Mono Lake Ranger District,9343,A05004,4,2016,111,1092,0,0,1203,111,1092,0,0,1203
504,DUR4,1,OUDS,Big Bend CG,Mono Lake Ranger District,9345,A05004,4,2016,174,1266,0,0,1440,174,1266,0,0,1440
504,DUR4,1,OUDS,Sawmill Walk-in CG,Mono Lake Ranger District,9347,A05004,4,2016,11,1092,0,0,1103,11,1092,0,0,1103
504,DUR4,1,OUDS,Saddlebag Lake CG,Mono Lake Ranger District,9348,A05004,4,2016,49,1727,0,0,1776,49,1727,0,0,1776
504,DUR4,1,OUDS,Ellery Lake CG,Mono Lake Ranger District,9349,A05004,4,2016,165,1183,0,0,1348,165,1183,0,0,1348
504,DUR4,1,OUDS,Silver Lake CG,Mono Lake Ranger District,9356,A05004,4,2016,62,5670,239,0,5971,62,5670,239,0,5971
504,DUR4,1,OUDS,Reversed Creek CG,Mono Lake Ranger District,9360,A05004,4,2016,501,1365,29,0,1895,501,1365,29,0,1895
504,DUR4,1,OUDS,Gull Lake CG,Mono Lake Ranger District,9361,A05004,4,2016,645,1001,52,0,1698,645,1001,52,0,1698
504,DUR4,1,OUDS,June Lake CG,Mono Lake Ranger District,9362,A05004,4,2016,1313,2548,106,0,3967,1313,2548,106,0,3967
504,RE4,1,OUDS,Tioga Pass Resort,Mono Lake Ranger District,9366,A05004,4,2016,267,1262,0,0,1529,267,1262,0,0,1529
504,RE4,1,OUDS,Silver Lake Resort Cabins,Mono Lake Ranger District,9367,A05004,4,2016,806,1471,254,0,2531,806,1471,254,0,2531
504,RE4,1,OUDS,Big Rock Landing Resort,Mono Lake Ranger District,9371,A05004,4,2016,2467,3753,39,80,6339,2467,3753,39,80,6339
504,RE4,1,OUDS,Boulder Lodge,Mono Lake Ranger District,9372,A05004,4,2016,1612,3106,390,356,5464,1612,3106,390,356,5464
504,DUR4,1,OUDS,Grant Lake Marina,Mono Lake Ranger District,9381,A05004,4,2016,1426,5426,38,0,6890,1426,5426,38,0,6890
504,SV1,1,DUDS,June Mountain Ski Area,Mono Lake Ranger District,9384,A05004,4,2016,3622,0,14365,48047,66034,3622,0,14365,48047,66034
504,DUR4,1,OUDS,Oh! Ridge CG,Mono Lake Ranger District,9393,A05004,4,2016,3719,13013,451,0,17183,3719,13013,451,0,17183
504,DUR4,1,OUDS,Junction CG,Mono Lake Ranger District,9395,A05004,4,2016,193,1183,0,0,1376,193,1183,0,0,1376
504,DUR4,1,OUDS,Old Shady Rest CG,Mammoth Ranger District,9428,A05004,4,2016,814,3358,0,0,4172,814,3358,0,0,4172
504,DUR4,1,OUDS,Upper Soda Springs CG,Mammoth Ranger District,9433,A05004,4,2016,131,2044,0,0,2175,131,2044,0,0,2175
504,DUR4,1,OUDS,Pumice Flat CG,Mammoth Ranger District,9434,A05004,4,2016,150,1168,0,0,1318,150,1168,0,0,1318
504,DUR4,1,OUDS,Minaret Falls CG,Mammoth Ranger District,9435,A05004,4,2016,213,1914,0,0,2127,213,1914,0,0,2127
504,DUR4,1,OUDS,Reds Meadow CG,Mammoth Ranger District,9436,A05004,4,2016,759,4914,0,0,5673,759,4914,0,0,5673
504,DUR4,1,OUDS,Twin Lakes CG,Mammoth Ranger District,9439,A05004,4,2016,3111,6205,316,0,9632,3111,6205,316,0,9632
504,DUR4,1,OUDS,Coldwater CG,Mammoth Ranger District,9440,A05004,4,2016,1387,6612,0,0,7999,1387,6612,0,0,7999
504,DUR4,1,OUDS,Lake George CG,Mammoth Ranger District,9441,A05004,4,2016,298,1168,0,0,1466,298,1168,0,0,1466
504,DUR4,1,OUDS,Lake Mary CG,Mammoth Ranger District,9442,A05004,4,2016,805,3168,0,0,3973,805,3168,0,0,3973
504,DUR4,1,OUDS,Pine City CG,Mammoth Ranger District,9443,A05004,4,2016,159,730,0,0,889,159,730,0,0,889
504,DUR4,1,OUDS,Sherwin Creek CG,Mammoth Ranger District,9444,A05004,4,2016,1319,6205,0,0,7524,1319,6205,0,0,7524
504,DUR4,1,OUDS,Convict Lake CG,Mammoth Ranger District,9445,A05004,4,2016,3784,5715,960,0,10459,3784,5715,960,0,10459
504,DUR5,1,OUDS,Pumice Flat Group CG,Mammoth Ranger District,9449,A05004,4,2016,36,292,0,0,328,36,292,0,0,328
504,DUR4,1,OUDS,New Shady Rest CG,Mammoth Ranger District,9464,A05004,4,2016,2018,8463,84,0,10565,2018,8463,84,0,10565
504,DUR5,1,OUDS,Pine Glen Group CG,Mammoth Ranger District,9465,A05004,4,2016,23,1479,0,0,1502,23,1479,0,0,1502
504,RE4,1,OUDS,Woods Lodge,Mammoth Ranger District,9468,A05004,4,2016,52,205,29,0,286,52,205,29,0,286
504,RE4,1,OUDS,Wildyrie Lodge,Mammoth Ranger District,9469,A05004,4,2016,29,173,0,0,202,29,173,0,0,202
504,RE4,1,OUDS,Tamarack Lodge,Mammoth Ranger District,9470,A05004,4,2016,1921,3353,4232,2975,12481,1921,3353,4232,2975,12481
504,RE4,1,OUDS,Crystal Crag Lodge,Mammoth Ranger District,9471,A05004,4,2016,664,1951,0,0,2615,664,1951,0,0,2615
504,RE4,1,OUDS,Convict Lake Resort,Mammoth Ranger District,9472,A05004,4,2016,802,895,803,695,3195,802,895,803,695,3195
504,RE4,1,OUDS,Reds Meadow Resort,Mammoth Ranger District,9480,A05004,4,2016,83,412,0,0,495,83,412,0,0,495
504,SV1,1,DUDS,Mammoth Mt. Ski Area Winter,Mammoth Ranger District,9497,A05004,4,2016,157536,2109,298175,728922,1186742,157536,2109,298175,728922,1186742
504,DUR4,1,OUDS,Mammoth Mtn RV Park,Mammoth Ranger District,9514,A05004,4,2016,10899,16301,4370,3999,35569,10899,16301,4370,3999,35569
504,SV1,1,DUDS,Tamarack Nordic Ski,Mammoth Ranger District,9522,A05004,4,2016,1145,0,4214,11889,17248,1145,0,4214,11889,17248
504,DUR4,1,OUDS,Big Meadow CG,White Mountain Ranger District,9532,A05004,4,2016,348,907,82,0,1337,348,907,82,0,1337
504,DUR4,1,OUDS,French Camp CG,White Mountain Ranger District,9533,A05004,4,2016,2813,3992,341,0,7146,2813,3992,341,0,7146
504,DUR4,1,OUDS,McGee Creek CG,White Mountain Ranger District,9534,A05004,4,2016,755,1295,115,0,2165,755,1295,115,0,2165
504,DUR5,1,OUDS,Aspen Group CG,White Mountain Ranger District,9535,A05004,4,2016,26,119,3,0,148,26,119,3,0,148
504,DUR4,1,OUDS,Iris Meadow CG,White Mountain Ranger District,9536,A05004,4,2016,477,930,71,0,1478,477,930,71,0,1478
504,DUR4,1,OUDS,Palisade  CG,White Mountain Ranger District,9537,A05004,4,2016,29,47,0,0,76,29,47,0,0,76
504,DUR4,1,OUDS,East Fork CG,White Mountain Ranger District,9538,A05004,4,2016,1949,5465,136,0,7550,1949,5465,136,0,7550
504,DUR4,1,OUDS,Tuff Campground,White Mountain Ranger District,9539,A05004,4,2016,1022,1177,53,0,2252,1022,1177,53,0,2252
504,DUR4,1,OUDS,Lower Pine Grove CG,White Mountain Ranger District,9540,A05004,4,2016,186,631,3,0,820,186,631,3,0,820
504,DUR4,1,OUDS,Rock Creek Lake CG,White Mountain Ranger District,9542,A05004,4,2016,626,1786,222,0,2634,626,1786,222,0,2634
504,DUR4,1,OUDS,Big Trees CG,White Mountain Ranger District,9544,A05004,4,2016,401,763,116,0,1280,401,763,116,0,1280
504,DUR4,1,OUDS,Bishop Park CG,White Mountain Ranger District,9545,A05004,4,2016,350,798,78,0,1226,350,798,78,0,1226
504,DUR4,1,OUDS,North Lake CG,White Mountain Ranger District,9546,A05004,4,2016,0,0,0,0,0,0,0,0,0,0
504,DUR4,1,OUDS,Silver Lake Resort RV Park,Mono Lake Ranger District,114,A05004,4,2016,4609,6716,989,0,12314,4609,6716,989,0,12314
504,FR1,1,DUDS,Mammoth Mtn. Ski Area Summer,Mammoth Ranger District,13,A05004,4,2016,19887,86628,0,0,106515,19887,86628,0,0,106515
504,RE4,1,OUDS,Tom's Place Resort,White Mountain Ranger District,130,A05004,4,2016,297,522,169,73,1061,297,522,169,73,1061
504,PTC3,1,VIEWCORR,Hwy 395 View Corridor,Mammoth Ranger District,229,A05004,4,2016,0,0,0,0,1610400,0,0,0,0,1610400
504,PTC3,1,VIEWCORR,West Guard Pass/Hwy 168,White Mountain Ranger District,230,A05004,4,2016,0,0,0,0,168363,0,0,0,0,168363
504,PTC3,1,VIEWCORR,Hwy 120 East,White Mountain Ranger District,231,A05004,4,2016,0,0,0,0,486780,0,0,0,0,486780
504,DUR5,1,OUDS,Whitney Portal Group CG,Mt. Whitney Ranger District,46053,A05004,4,2016,90,209,26,0,325,90,209,26,0,325
504,DUR4,1,OUDS,Sabrina CG,White Mountain Ranger District,9547,A05004,4,2016,432,1716,110,0,2258,432,1716,110,0,2258
504,DUR4,1,OUDS,Four Jeffery CG,White Mountain Ranger District,9548,A05004,4,2016,1125,3301,269,0,4695,1125,3301,269,0,4695
504,DUR4,1,OUDS,Mountain Glen CG,White Mountain Ranger District,9549,A05004,4,2016,32,189,0,0,221,32,189,0,0,221
504,DUR4,1,OUDS,Willow CG,White Mountain Ranger District,9551,A05004,4,2016,96,482,0,0,578,96,482,0,0,578
504,DUR4,1,OUDS,Upper Sage Flat CG,White Mountain Ranger District,9554,A05004,4,2016,337,1030,31,0,1398,337,1030,31,0,1398
504,DUR4,1,OUDS,Big Pine Creek CG,White Mountain Ranger District,9556,A05004,4,2016,335,1740,233,0,2308,335,1740,233,0,2308
504,DUR4,1,OUDS,Forks Campground,White Mountain Ranger District,9560,A05004,4,2016,247,454,100,0,801,247,454,100,0,801
504,DUR4,1,OUDS,Intake 2 Upper CG,White Mountain Ranger District,9562,A05004,4,2016,541,893,170,0,1604,541,893,170,0,1604
504,RE4,1,OUDS,Rock Creek Lodge,White Mountain Ranger District,9572,A05004,4,2016,384,1223,90,131,1828,384,1223,90,131,1828
504,RE4,1,OUDS,Rock Creek Lakes Resort,White Mountain Ranger District,9573,A05004,4,2016,260,804,62,0,1126,260,804,62,0,1126
504,RE4,1,OUDS,Parcher's Resort,White Mountain Ranger District,9576,A05004,4,2016,637,1681,197,0,2515,637,1681,197,0,2515
504,RE4,1,OUDS,Glacier Lodge,White Mountain Ranger District,9577,A05004,4,2016,171,412,62,0,645,171,412,62,0,645
504,DUR4,1,OUDS,Sage Flat CG,White Mountain Ranger District,9609,A05004,4,2016,636,1329,177,0,2142,636,1329,177,0,2142
504,DUR4,1,OUDS,Upper Pine Grove CG,White Mountain Ranger District,9612,A05004,4,2016,138,567,3,0,708,138,567,3,0,708
504,DUR5,1,OUDS,Palisade/Clyde Group CG,White Mountain Ranger District,9613,A05004,4,2016,0,0,0,0,0,0,0,0,0,0
504,DUR4,1,OUDS,Grays Meadow CG,Mt. Whitney Ranger District,9618,A05004,4,2016,2122,1871,195,0,4188,2122,1871,195,0,4188
504,DUR4,1,OUDS,Onion Valley CG,Mt. Whitney Ranger District,9620,A05004,4,2016,454,1264,165,0,1883,454,1264,165,0,1883
504,DUR4,1,OUDS,Lone Pine CG,Mt. Whitney Ranger District,9621,A05004,4,2016,1382,1705,439,0,3526,1382,1705,439,0,3526
504,DUR4,1,OUDS,Whitney Portal CG,Mt. Whitney Ranger District,9622,A05004,4,2016,1362,2905,593,0,4860,1362,2905,593,0,4860
504,DUR5,1,OUDS,Bishop Park Group CG,Mt. Whitney Ranger District,9624,A05004,4,2016,110,245,35,0,390,110,245,35,0,390
504,DUR5,1,OUDS,Rock Creek Lake Group CG,Mt. Whitney Ranger District,9625,A05004,4,2016,19,38,103,0,160,19,38,103,0,160
504,DUR4,1,OUDS,Whitney Trailhead Walk-in CG,Mt. Whitney Ranger District,46055,A05004,4,2016,71,395,92,0,558,71,395,92,0,558
504,DUR5,1,OUDS,Table Mountain Group CG,White Mountain Ranger District,66,A05004,4,2016,0,0,0,0,0,0,0,0,0,0
504,DUR5,1,OUDS,Obsidian Flat Group CG,Mono Lake Ranger District,239663,A05004,4,2016,30,66,0,0,96,30,66,0,0,96
504,DUR5,1,OUDS,Nelson Group CG,White Mountain Ranger District,239654,A05004,4,2016,40,37,0,0,77,40,37,0,0,77
504,DUR5,1,OUDS,Ferguson Group CG,White Mountain Ranger District,239652,A05004,4,2016,19,12,1,0,32,19,12,1,0,32
504,DUR5,1,OUDS,Noren Group CG,White Mountain Ranger District,239653,A05004,4,2016,16,9,0,0,25,16,9,0,0,25
504,DUR5,1,OUDS,Trailhead Group CG (Saddlebag Lk),Mono Lake Ranger District,239661,A05004,4,2016,4,91,0,0,95,4,91,0,0,95
504,DUR4,1,OUDS,Bitterbrush CG - proxy,White Mountain Ranger District,239664,A05004,4,2016,316,594,86,0,996,316,594,86,0,996
515,RE4,1,OUDS,Lakeview Cottages,High Sierra Ranger District,11630,A05015,4,2017,305,823,0,0,1128,305,823,0,0,1128
515,DUR4,1,OUDS,Dinkey Creek Campground,High Sierra Ranger District,11680,A05015,4,2017,2094,6869,187,0,9150,2094,6869,187,0,9150
515,DUR4,1,OUDS,Buck Meadow Campground,High Sierra Ranger District,11682,A05015,4,2017,125,287,0,0,412,125,287,0,0,412
515,DUR4,1,OUDS,Marmot Rock Campground,High Sierra Ranger District,11698,A05015,4,2017,14,857,30,0,901,14,857,30,0,901
515,DUR5,1,OUDS,Kirch Flat Group CG,High Sierra Ranger District,11706,A05015,4,2017,27,16,0,6,49,27,16,0,6,49
515,RE4,1,OUDS,Dinkey Creek Resort Lodge,High Sierra Ranger District,11735,A05015,4,2017,360,360,0,0,720,360,360,0,0,720
515,DUR4,1,OUDS,Wishon Village,High Sierra Ranger District,11737,A05015,4,2017,3575,8181,2015,900,14671,3575,8181,2015,900,14671
515,DUR4,1,OUDS,Sweetwater CG,Bass Lake Ranger District,11759,A05015,4,2017,0,0,0,0,0,0,0,0,0,0
515,DUR4,1,OUDS,Mammoth Pool CG,Bass Lake Ranger District,11760,A05015,4,2017,0,0,0,0,0,0,0,0,0,0
515,DUR4,1,OUDS,Lower Chiquito CG,Bass Lake Ranger District,11775,A05015,4,2017,0,0,0,0,0,0,0,0,0,0
515,DUR4,1,OUDS,Portal Forebay CG,High Sierra Ranger District,11815,A05015,4,2017,0,156,0,0,156,0,156,0,0,156
515,DUR4,1,OUDS,Ward Lake Campground,High Sierra Ranger District,11816,A05015,4,2017,0,203,0,0,203,0,203,0,0,203
515,DUR4,1,OUDS,Jackass Meadows Campground,High Sierra Ranger District,11817,A05015,4,2017,0,0,0,0,0,0,0,0,0,0
515,DUR4,1,OUDS,Mono Hot Springs CG,High Sierra Ranger District,11823,A05015,4,2017,0,1101,0,0,1101,0,1101,0,0,1101
515,DUR4,1,OUDS,Catavee Campground,High Sierra Ranger District,22423,A05015,4,2017,794,1086,0,0,1880,794,1086,0,0,1880
515,DUR4,1,OUDS,Gigantea Campground,High Sierra Ranger District,22439,A05015,4,2017,0,0,0,0,0,0,0,0,0,0
515,DUR4,1,OUDS,Mono Creek Campground,High Sierra Ranger District,11825,A05015,4,2017,4,212,0,0,216,4,212,0,0,216
515,DUR4,1,OUDS,Vermillion Campground,High Sierra Ranger District,11826,A05015,4,2017,70,1333,0,0,1403,70,1333,0,0,1403
515,RE4,1,OUDS,Mono Hot Springs Resort Lodge,High Sierra Ranger District,11852,A05015,4,2017,332,2152,260,0,2744,332,2152,260,0,2744
515,RE4,1,OUDS,Vermillion Valley Resort Lodge,High Sierra Ranger District,11853,A05015,4,2017,138,963,56,0,1157,138,963,56,0,1157
515,DUR4,1,OUDS,Lupine/Cedar CG,Bass Lake Ranger District,11876,A05015,4,2017,987,3094,605,95,4781,987,3094,605,95,4781
515,DUR4,1,OUDS,Spring Cove CG,Bass Lake Ranger District,11878,A05015,4,2017,1134,2688,0,0,3822,1134,2688,0,0,3822
515,DUR4,1,OUDS,Wishon Point CG,Bass Lake Ranger District,11879,A05015,4,2017,1034,2110,0,0,3144,1034,2110,0,0,3144
515,DUR4,1,OUDS,Chilkoot CG,Bass Lake Ranger District,11880,A05015,4,2017,0,28,0,0,28,0,28,0,0,28
515,DUR4,1,OUDS,Grey's Mountain CG,Bass Lake Ranger District,11882,A05015,4,2017,0,0,0,0,0,0,0,0,0,0
515,DUR4,1,OUDS,Soquel CG,Bass Lake Ranger District,11883,A05015,4,2017,309,374,0,0,683,309,374,0,0,683
515,DUR5,1,OUDS,Texas Flat Group CG,Bass Lake Ranger District,11884,A05015,4,2017,0,0,0,0,0,0,0,0,0,0
515,DUR4,1,OUDS,Kelty Meadow CG,Bass Lake Ranger District,11885,A05015,4,2017,170,213,0,0,383,170,213,0,0,383
515,DUR4,1,OUDS,Summerdale CG,Bass Lake Ranger District,11889,A05015,4,2017,1425,1469,0,0,2894,1425,1469,0,0,2894
515,DUR4,1,OUDS,Big Sandy CG,Bass Lake Ranger District,11891,A05015,4,2017,25,163,0,0,188,25,163,0,0,188
515,DUR4,1,OUDS,Soda Springs CG,Bass Lake Ranger District,22903,A05015,4,2017,0,0,0,0,0,0,0,0,0,0
515,DUR4,1,OUDS,Fish Creek CG,Bass Lake Ranger District,11587,A05015,4,2017,0,0,0,0,0,0,0,0,0,0
515,DUR4,1,OUDS,Rock Creek CG,Bass Lake Ranger District,11588,A05015,4,2017,0,0,0,0,0,0,0,0,0,0
515,DUR4,1,OUDS,Fresno Dome Campground,Bass Lake Ranger District,11893,A05015,4,2017,0,0,0,0,0,0,0,0,0,0
515,DUR5,1,OUDS,Recreation Point Group CG,Bass Lake Ranger District,11898,A05015,4,2017,42,180,31,0,253,42,180,31,0,253
515,RE4,1,OUDS,Forks Resort Lodge,Bass Lake Ranger District,11909,A05015,4,2017,500,923,132,0,1555,500,923,132,0,1555
515,RE4,1,OUDS,Miller's Resort Lodge,Bass Lake Ranger District,11910,A05015,4,2017,543,763,154,61,1521,543,763,154,61,1521
515,DUR5,1,OUDS,Crane Valley Group CG,Bass Lake Ranger District,29531,A05015,4,2017,0,0,0,0,0,0,0,0,0,0
515,SV1,1,DUDS,China Peak Mountain Resort,High Sierra Ranger District,30,A05015,4,2017,11504,1404,21309,82691,116908,11504,1404,21309,82691,116908
515,DUR4,1,OUDS,Whiskers CG,Bass Lake Ranger District,34507,A05015,4,2017,0,72,0,0,72,0,72,0,0,72
515,DUR4,1,OUDS,Trapper Springs Campground,High Sierra Ranger District,35107,A05015,4,2017,0,1533,27,0,1560,0,1533,27,0,1560
515,DUR4,1,OUDS,Dirt Flat CG,Bass Lake Ranger District,51504,A05015,4,2017,206,198,103,23,530,206,198,103,23,530
515,DUR4,1,OUDS,Dry Gulch CG,Bass Lake Ranger District,51505,A05015,4,2017,282,294,119,58,753,282,294,119,58,753
515,DUR4,1,OUDS,Gaggs Creek CG,Bass Lake Ranger District,11590,A05015,4,2017,0,73,0,0,73,0,73,0,0,73
515,DUR4,1,OUDS,Dorabelle Campground,High Sierra Ranger District,11606,A05015,4,2017,1274,3587,209,0,5070,1274,3587,209,0,5070
515,DUR4,1,OUDS,Swanson Meadow CG,High Sierra Ranger District,11607,A05015,4,2017,0,0,0,0,0,0,0,0,0,0
515,DUR4,1,OUDS,Rancheria Campground,High Sierra Ranger District,11608,A05015,4,2017,1910,5551,258,0,7719,1910,5551,258,0,7719
515,DUR4,1,OUDS,College Campground,High Sierra Ranger District,11609,A05015,4,2017,195,604,0,0,799,195,604,0,0,799
515,DUR4,1,OUDS,Deer Creek Campground,High Sierra Ranger District,11610,A05015,4,2017,697,1126,0,0,1823,697,1126,0,0,1823
515,DUR4,1,OUDS,Kinnikinnick Campground,High Sierra Ranger District,11611,A05015,4,2017,357,1129,0,0,1486,357,1129,0,0,1486
515,DUR4,1,OUDS,Badger Flat Family CG,High Sierra Ranger District,11619,A05015,4,2017,0,1284,0,0,1284,0,1284,0,0,1284
515,RE4,1,OUDS,China Peak Lodge,High Sierra Ranger District,11626,A05015,4,2017,702,725,429,2395,4251,702,725,429,2395,4251
515,RE4,1,OUDS,Lakeshore Resort Lodge,High Sierra Ranger District,11627,A05015,4,2017,1307,3803,326,360,5796,1307,3803,326,360,5796
515,RE4,1,OUDS,Cedar Crest Lodge,High Sierra Ranger District,11628,A05015,4,2017,0,0,0,0,0,0,0,0,0,0
515,RE4,1,OUDS,Huntington Lake Resort Lodge,High Sierra Ranger District,11629,A05015,4,2017,0,0,0,0,0,0,0,0,0,0
515,DUR5,1,OUDS,Upper Kings Group CG,High Sierra Ranger District,91,A05015,4,2017,0,0,0,0,0,0,0,0,0,0
515,DUR5,1,OUDS,Dinkey Group CG,High Sierra Ranger District,96,A05015,4,2017,3,71,0,0,74,3,71,0,0,74
515,DUR4,1,OUDS,Placer CG,Bass Lake Ranger District,11758,A05015,4,2017,0,0,0,0,0,0,0,0,0,0
515,DUR4,1,OUDS,Forks CG,Bass Lake Ranger District,11875,A05015,4,2017,862,1307,0,0,2169,862,1307,0,0,2169
516,DUR4,1,OUDS,Pinecrest Campground,Summit Ranger District,17,A05016,4,2017,8059,14945,992,0,23996,8059,14945,992,0,23996
516,DUR4,1,OUDS,Meadowview Campground,Summit Ranger District,18,A05016,4,2017,2137,4949,45,0,7131,2137,4949,45,0,7131
516,DUR4,1,OUDS,Clark Fork Campground,Summit Ranger District,19,A05016,4,2017,1070,2361,46,0,3477,1070,2361,46,0,3477
516,DUR4,1,OUDS,Big Meadow Campground,Calaveras Ranger District,20,A05016,4,2017,135,936,62,0,1133,135,936,62,0,1133
516,DUR4,1,OUDS,Sand Flat Campground,Summit Ranger District,21,A05016,4,2017,1022,2241,50,0,3313,1022,2241,50,0,3313
516,DUR4,1,OUDS,Cherry Valley CG,Groveland Ranger District,22,A05016,4,2017,945,1243,0,0,2188,945,1243,0,0,2188
516,DUR4,1,OUDS,Lake Alpine Campground,Calaveras Ranger District,23,A05016,4,2017,150,1803,0,0,1953,150,1803,0,0,1953
516,DUR4,1,OUDS,Baker Campground,Summit Ranger District,24,A05016,4,2017,883,2280,4,0,3167,883,2280,4,0,3167
516,DUR5,1,OUDS,Pioneer Trail Group CG,Summit Ranger District,26,A05016,4,2017,102,175,12,0,289,102,175,12,0,289
516,DUR4,1,OUDS,Fraser Flat Campground,Mi-Wok Ranger District,27,A05016,4,2017,1380,1978,98,0,3456,1380,1978,98,0,3456
516,DUR4,1,OUDS,"Dimond ""O"" Campground",Groveland Ranger District,29,A05016,4,2017,1944,2278,75,0,4297,1944,2278,75,0,4297
516,DUR4,1,OUDS,Brightman Campground,Summit Ranger District,31,A05016,4,2017,563,1053,47,0,1663,563,1053,47,0,1663
516,DUR4,1,OUDS,Pine Marten Campground,Calaveras Ranger District,32,A05016,4,2017,30,1766,0,0,1796,30,1766,0,0,1796
516,DUR4,1,OUDS,Lodgepole Overflow CG,Calaveras Ranger District,33,A05016,4,2017,9,340,0,0,349,9,340,0,0,349
516,DUR4,1,OUDS,Dardanelle Campground,Summit Ranger District,35,A05016,4,2017,315,846,0,0,1161,315,846,0,0,1161
516,DUR4,1,OUDS,Eureka Valley CG,Summit Ranger District,36,A05016,4,2017,417,1088,29,0,1534,417,1088,29,0,1534
516,DUR4,1,OUDS,Silvertip Campground,Calaveras Ranger District,37,A05016,4,2017,92,881,0,0,973,92,881,0,0,973
516,DUR4,1,OUDS,The Pines Campground,Groveland Ranger District,38,A05016,4,2017,564,575,44,0,1183,564,575,44,0,1183
516,DUR4,1,OUDS,Silver Valley CG,Calaveras Ranger District,39,A05016,4,2017,3,762,0,0,765,3,762,0,0,765
516,DUR4,1,OUDS,Boulder Flat CG,Summit Ranger District,41,A05016,4,2017,89,355,0,0,444,89,355,0,0,444
516,DUR4,1,OUDS,Deadman Campground,Summit Ranger District,43,A05016,4,2017,632,1222,0,0,1854,632,1222,0,0,1854
516,DUR4,1,OUDS,Clark Fork Equestrian CG,Summit Ranger District,47,A05016,4,2017,0,0,3,0,3,0,0,3,0,3
516,DUR4,1,OUDS,Sweetwater Campground,Groveland Ranger District,48,A05016,4,2017,650,727,59,0,1436,650,727,59,0,1436
516,DUR4,1,OUDS,Lost Claim Campground,Groveland Ranger District,52,A05016,4,2017,504,634,27,0,1165,504,634,27,0,1165
516,SV1,1,DUDS,Dodge Ridge Ski Area,Summit Ranger District,14,A05016,4,2017,12164,0,13662,93533,119359,12164,0,13662,93533,119359
516,ST1,1,DUDS,Bear Valley Ski Area,Calaveras Ranger District,15,A05016,4,2017,12242,0,22990,68147,103379,12242,0,22990,68147,103379
516,DUR4,1,OUDS,Backpackers Campground,Calaveras Ranger District,56,A05016,4,2017,0,135,0,0,135,0,135,0,0,135
516,DUR4,1,OUDS,Pigeon Flat Campground,Summit Ranger District,58,A05016,4,2017,65,192,11,0,268,65,192,11,0,268
516,DUR4,1,OUDS,Wa Ka Luu Hep Yoo CG,Calaveras Ranger District,59,A05016,4,2017,522,1135,117,0,1774,522,1135,117,0,1774
516,DUR4,1,OUDS,Stanislaus River CG,Calaveras Ranger District,63,A05016,4,2017,0,967,0,0,967,0,967,0,0,967
516,DUR5,1,OUDS,Lodgepole Group CG,Calaveras Ranger District,64,A05016,4,2017,8,86,0,0,94,8,86,0,0,94
516,DUR4,1,OUDS,Pinecrest Chalet CG - RV Sites,Summit Ranger District,65,A05016,4,2017,268,527,70,7,872,268,527,70,7,872
516,DUR4,1,OUDS,Dardanelle Resort CG,Summit Ranger District,66,A05016,4,2017,0,0,0,0,0,0,0,0,0,0
516,RE4,1,OUDS,Pinecrest Lake Resort,Summit Ranger District,67,A05016,4,2017,1182,2122,587,899,4790,1182,2122,587,899,4790
516,RE4,1,OUDS,Pinecrest Chalet Cabins,Summit Ranger District,68,A05016,4,2017,687,1340,419,793,3239,687,1340,419,793,3239
516,RE4,1,OUDS,Dardanelle Resort,Summit Ranger District,69,A05016,4,2017,0,0,0,0,0,0,0,0,0,0
516,RE4,1,OUDS,Lake Alpine Lodge,Calaveras Ranger District,70,A05016,4,2017,54,703,20,0,777,54,703,20,0,777
516,ST1,1,DUDS,Bear Valley X Country,Calaveras Ranger District,16,A05016,4,2017,599,0,2052,5159,7810,599,0,2052,5159,7810
516,PTC3,1,VIEWCORR,State Highway 108,Summit Ranger District,163,A05016,4,2017,0,0,0,0,0,0,0,0,0,0
516,PTC3,1,VIEWCORR,Route 4 - Ebbetts Pass,Calaveras Ranger District,164,A05016,4,2017,0,0,0,0,0,0,0,0,0,0
504,DUR4,1,OUDS,Tioga Lake CG,Mono Lake Ranger District,9343,A05004,5,2021,127,1222,0,0,1349,127,1222,0,0,1349
504,DUR4,1,OUDS,Big Bend CG,Mono Lake Ranger District,9345,A05004,5,2021,185,1333,0,0,1518,185,1333,0,0,1518
504,DUR4,1,OUDS,Sawmill Walk-in CG,Mono Lake Ranger District,9347,A05004,5,2021,24,1254,0,0,1278,24,1254,0,0,1278
504,DUR4,1,OUDS,Saddlebag Lake CG,Mono Lake Ranger District,9348,A05004,5,2021,63,2351,0,0,2414,63,2351,0,0,2414
504,DUR4,1,OUDS,Ellery Lake CG,Mono Lake Ranger District,9349,A05004,5,2021,192,1310,0,0,1502,192,1310,0,0,1502
504,DUR4,1,OUDS,Silver Lake CG,Mono Lake Ranger District,9356,A05004,5,2021,88,5870,166,0,6124,88,5870,166,0,6124
504,DUR4,1,OUDS,Reversed Creek CG,Mono Lake Ranger District,9360,A05004,5,2021,534,1412,17,0,1963,534,1412,17,0,1963
504,DUR4,1,OUDS,Gull Lake CG,Mono Lake Ranger District,9361,A05004,5,2021,725,1221,45,0,1991,725,1221,45,0,1991
504,DUR4,1,OUDS,June Lake CG,Mono Lake Ranger District,9362,A05004,5,2021,1422,2631,67,0,4120,1422,2631,67,0,4120
504,DUR4,1,OUDS,Pine Cliff Resort,Mono Lake Ranger District,9363,A05004,5,2021,0,1257,83,0,1340,0,1257,83,0,1340
504,RE4,1,OUDS,Silver Lake Resort Cabins,Mono Lake Ranger District,9367,A05004,5,2021,751,1374,218,0,2343,751,1374,218,0,2343
504,RE4,1,OUDS,Big Rock Landing Resort,Mono Lake Ranger District,9371,A05004,5,2021,449,553,211,9,1222,449,553,211,9,1222
504,RE4,1,OUDS,Boulder Lodge,Mono Lake Ranger District,9372,A05004,5,2021,1730,3125,281,326,5462,1730,3125,281,326,5462
504,DUR4,1,OUDS,Grant Lake Marina,Mono Lake Ranger District,9381,A05004,5,2021,1610,5728,26,0,7364,1610,5728,26,0,7364
504,SV1,1,DUDS,June Mountain Ski Area,Mono Lake Ranger District,9384,A05004,5,2021,7652,0,0,47221,54873,7652,0,0,47221,54873
504,DUR4,1,OUDS,Oh! Ridge CG,Mono Lake Ranger District,9393,A05004,5,2021,3877,14127,319,0,18323,3877,14127,319,0,18323
504,DUR4,1,OUDS,Junction CG,Mono Lake Ranger District,9395,A05004,5,2021,201,1252,0,0,1453,201,1252,0,0,1453
504,PTC3,1,DUDS,South Tufa,Mono Lake Ranger District,9410,A05004,5,2021,1365,2190,804,286,4645,1365,2190,804,286,4645
504,DUR4,1,OUDS,Old Shady Rest CG,Mammoth Ranger District,9428,A05004,5,2021,911,3361,0,0,4272,911,3361,0,0,4272
504,DUR4,1,OUDS,Upper Soda Springs CG,Mammoth Ranger District,9433,A05004,5,2021,212,2003,0,0,2215,212,2003,0,0,2215
504,DUR4,1,OUDS,Pumice Flat CG,Mammoth Ranger District,9434,A05004,5,2021,234,2261,0,0,2495,234,2261,0,0,2495
504,DUR4,1,OUDS,Minaret Falls CG,Mammoth Ranger District,9435,A05004,5,2021,207,2333,0,0,2540,207,2333,0,0,2540
504,DUR4,1,OUDS,Reds Meadow CG,Mammoth Ranger District,9436,A05004,5,2021,657,5322,0,0,5979,657,5322,0,0,5979
504,DUR4,1,OUDS,Twin Lakes CG,Mammoth Ranger District,9439,A05004,5,2021,3109,6411,179,0,9699,3109,6411,179,0,9699
504,DUR4,1,OUDS,Coldwater CG,Mammoth Ranger District,9440,A05004,5,2021,1483,6867,0,0,8350,1483,6867,0,0,8350
504,DUR4,1,OUDS,Lake George CG,Mammoth Ranger District,9441,A05004,5,2021,333,1396,0,0,1729,333,1396,0,0,1729
504,DUR4,1,OUDS,Lake Mary CG,Mammoth Ranger District,9442,A05004,5,2021,800,4014,0,0,4814,800,4014,0,0,4814
504,DUR4,1,OUDS,Pine City CG,Mammoth Ranger District,9443,A05004,5,2021,179,982,0,0,1161,179,982,0,0,1161
504,DUR4,1,OUDS,Sherwin Creek CG,Mammoth Ranger District,9444,A05004,5,2021,1295,6636,0,0,7931,1295,6636,0,0,7931
504,DUR4,1,OUDS,Convict Lake CG,Mammoth Ranger District,9445,A05004,5,2021,4109,6183,741,0,11033,4109,6183,741,0,11033
504,DUR5,1,OUDS,Pumice Flat Group CG,Mammoth Ranger District,9449,A05004,5,2021,41,357,0,0,398,41,357,0,0,398
504,DUR4,1,OUDS,New Shady Rest CG,Mammoth Ranger District,9464,A05004,5,2021,2380,9141,112,0,11633,2380,9141,112,0,11633
504,DUR5,1,OUDS,Pine Glen Group CG,Mammoth Ranger District,9465,A05004,5,2021,25,1578,0,0,1603,25,1578,0,0,1603
504,RE4,1,OUDS,Woods Lodge,Mammoth Ranger District,9468,A05004,5,2021,61,186,21,0,268,61,186,21,0,268
504,RE4,1,OUDS,Wildyrie Lodge,Mammoth Ranger District,9469,A05004,5,2021,35,185,0,0,220,35,185,0,0,220
504,RE4,1,OUDS,Tamarack Lodge,Mammoth Ranger District,9470,A05004,5,2021,2518,2575,1173,1503,7769,2518,2575,1173,1503,7769
504,RE4,1,OUDS,Crystal Crag Lodge,Mammoth Ranger District,9471,A05004,5,2021,500,1100,100,0,1700,500,1100,100,0,1700
504,RE4,1,OUDS,Convict Lake Resort,Mammoth Ranger District,9472,A05004,5,2021,2407,2229,1584,1384,7604,2407,2229,1584,1384,7604
504,RE4,1,OUDS,Reds Meadow Resort,Mammoth Ranger District,9480,A05004,5,2021,79,416,0,0,495,79,416,0,0,495
504,SV1,1,DUDS,Mammoth Mt. Ski Area Winter,Mammoth Ranger District,9497,A05004,5,2021,197304,0,186260,570621,954185,197304,0,186260,570621,954185
504,DUR4,1,OUDS,Mammoth Mtn RV Park,Mammoth Ranger District,9514,A05004,5,2021,12998,17210,3289,2789,36286,12998,17210,3289,2789,36286
504,SV1,1,DUDS,Tamarack Nordic Ski,Mammoth Ranger District,9522,A05004,5,2021,1526,0,1266,11056,13848,1526,0,1266,11056,13848
504,DUR4,1,OUDS,Big Meadow CG,White Mountain Ranger District,9532,A05004,5,2021,322,1117,62,0,1501,322,1117,62,0,1501
504,DUR4,1,OUDS,French Camp CG,White Mountain Ranger District,9533,A05004,5,2021,2800,4328,216,0,7344,2800,4328,216,0,7344
504,DUR4,1,OUDS,McGee Creek CG,White Mountain Ranger District,9534,A05004,5,2021,812,1396,125,0,2333,812,1396,125,0,2333
504,DUR5,1,OUDS,Aspen Group CG,White Mountain Ranger District,9535,A05004,5,2021,42,132,0,0,174,42,132,0,0,174
504,DUR4,1,OUDS,Iris Meadow CG,White Mountain Ranger District,9536,A05004,5,2021,489,1278,65,0,1832,489,1278,65,0,1832
504,DUR4,1,OUDS,Palisade  CG,White Mountain Ranger District,9537,A05004,5,2021,26,63,0,0,89,26,63,0,0,89
504,DUR4,1,OUDS,East Fork CG,White Mountain Ranger District,9538,A05004,5,2021,2158,6541,89,0,8788,2158,6541,89,0,8788
504,DUR4,1,OUDS,Tuff Campground,White Mountain Ranger District,9539,A05004,5,2021,1356,1377,37,0,2770,1356,1377,37,0,2770
504,DUR4,1,OUDS,Lower Pine Grove CG,White Mountain Ranger District,9540,A05004,5,2021,210,739,0,0,949,210,739,0,0,949
504,DUR4,1,OUDS,Rock Creek Lake CG,White Mountain Ranger District,9542,A05004,5,2021,789,1856,0,0,2645,789,1856,0,0,2645
504,DUR4,1,OUDS,Big Trees CG,White Mountain Ranger District,9544,A05004,5,2021,561,814,90,0,1465,561,814,90,0,1465
504,DUR4,1,OUDS,Bishop Park CG,White Mountain Ranger District,9545,A05004,5,2021,487,934,0,0,1421,487,934,0,0,1421
504,DUR4,1,OUDS,North Lake CG,White Mountain Ranger District,9546,A05004,5,2021,0,0,0,0,0,0,0,0,0,0
504,DUR4,1,OUDS,Silver Lake Resort RV Park,Mono Lake Ranger District,114,A05004,5,2021,4791,6812,753,0,12356,4791,6812,753,0,12356
504,FR1,1,DUDS,Mammoth Mtn. Ski Area Summer,Mammoth Ranger District,13,A05004,5,2021,22242,62814,0,0,85056,22242,62814,0,0,85056
504,RE4,1,OUDS,Tom's Place Resort,White Mountain Ranger District,130,A05004,5,2021,699,742,193,37,1671,699,742,193,37,1671
504,TB3,1,VIEWCORR,"120 West, Yosemite NP toll booth",Mono Lake Ranger District,180,A05004,5,2021,2836,6497,0,1323,10656,2836,6497,0,1323,10656
504,PTC3,1,VIEWCORR,Hwy 395 View Corridor,Mammoth Ranger District,229,A05004,5,2021,18875,22417,13456,10968,65716,18875,22417,13456,10968,65716
504,PTC3,1,VIEWCORR,"Highway 168/Ancient Bristlecone, Sierra View Overlook",White Mountain Ranger District,230,A05004,5,2021,1765,1612,1357,1038,5772,1765,1612,1357,1038,5772
504,PTC3,1,VIEWCORR,"Hwy 120 East, Lee Vining Canyon byway",Mono Lake Ranger District,231,A05004,5,2021,3831,7990,2015,319,14155,3831,7990,2015,319,14155
504,DUR4,1,OUDS,Four Jeffery CG,White Mountain Ranger District,9548,A05004,5,2021,1324,4134,0,0,5458,1324,4134,0,0,5458
504,DUR5,1,OUDS,Whitney Portal Group CG,Mt. Whitney Ranger District,46053,A05004,5,2021,125,231,21,0,377,125,231,21,0,377
504,DUR4,1,OUDS,Sabrina CG,White Mountain Ranger District,9547,A05004,5,2021,561,1959,0,0,2520,561,1959,0,0,2520
504,DUR4,1,OUDS,Mountain Glen CG,White Mountain Ranger District,9549,A05004,5,2021,67,231,0,0,298,67,231,0,0,298
504,DUR4,1,OUDS,Willow CG,White Mountain Ranger District,9551,A05004,5,2021,119,589,0,0,708,119,589,0,0,708
504,DUR4,1,OUDS,Upper Sage Flat CG,White Mountain Ranger District,9554,A05004,5,2021,460,1373,22,0,1855,460,1373,22,0,1855
504,DUR4,1,OUDS,Big Pine Creek CG,White Mountain Ranger District,9556,A05004,5,2021,478,1948,221,0,2647,478,1948,221,0,2647
504,DUR4,1,OUDS,Forks Campground,White Mountain Ranger District,9560,A05004,5,2021,378,671,81,0,1130,378,671,81,0,1130
504,DUR4,1,OUDS,Intake 2 Upper CG,White Mountain Ranger District,9562,A05004,5,2021,521,924,157,0,1602,521,924,157,0,1602
504,RE4,1,OUDS,Rock Creek Lodge,White Mountain Ranger District,9572,A05004,5,2021,349,1331,95,127,1902,349,1331,95,127,1902
504,RE4,1,OUDS,Rock Creek Lakes Resort,White Mountain Ranger District,9573,A05004,5,2021,255,832,51,0,1138,255,832,51,0,1138
504,RE4,1,OUDS,Parcher's Resort,White Mountain Ranger District,9576,A05004,5,2021,618,1483,338,0,2439,618,1483,338,0,2439
504,RE4,1,OUDS,Glacier Lodge,White Mountain Ranger District,9577,A05004,5,2021,36,75,22,0,133,36,75,22,0,133
504,DUR4,1,OUDS,Sage Flat CG,White Mountain Ranger District,9609,A05004,5,2021,757,1437,163,0,2357,757,1437,163,0,2357
504,DUR4,1,OUDS,Onion Valley CG,Mt. Whitney Ranger District,9620,A05004,5,2021,519,1367,0,0,1886,519,1367,0,0,1886
504,DUR4,1,OUDS,Upper Pine Grove CG,White Mountain Ranger District,9612,A05004,5,2021,243,571,0,0,814,243,571,0,0,814
504,DUR5,1,OUDS,Palisade/Clyde Group CG,White Mountain Ranger District,9613,A05004,5,2021,0,0,0,0,0,0,0,0,0,0
504,DUR4,1,OUDS,Upper Grays Meadow CG,Mt. Whitney Ranger District,9618,A05004,5,2021,0,0,0,0,0,0,0,0,0,0
504,DUR4,1,OUDS,Lone Pine CG,Mt. Whitney Ranger District,9621,A05004,5,2021,1451,1816,0,0,3267,1451,1816,0,0,3267
504,DUR4,1,OUDS,Whitney Portal CG,Mt. Whitney Ranger District,9622,A05004,5,2021,1471,3109,0,0,4580,1471,3109,0,0,4580
504,DUR5,1,OUDS,Bishop Park Group CG,White Mountain Ranger District,9624,A05004,5,2021,125,312,79,0,516,125,312,79,0,516
504,DUR5,1,OUDS,Rock Creek Lake Group CG,White Mountain Ranger District,9625,A05004,5,2021,38,45,89,0,172,38,45,89,0,172
504,DUR4,1,OUDS,Whitney Trailhead Walk-in CG,Mt. Whitney Ranger District,46055,A05004,5,2021,93,428,76,0,597,93,428,76,0,597
504,DUR5,1,OUDS,Table Mountain Group CG,White Mountain Ranger District,66,A05004,5,2021,0,0,0,0,0,0,0,0,0,0
504,DUR5,1,OUDS,Obsidian Flat Group CG,Mono Lake Ranger District,239663,A05004,5,2021,42,71,0,0,113,42,71,0,0,113
504,DUR5,1,OUDS,Nelson Group CG,White Mountain Ranger District,239654,A05004,5,2021,55,46,0,0,101,55,46,0,0,101
504,DUR5,1,OUDS,Ferguson Group CG,White Mountain Ranger District,239652,A05004,5,2021,38,23,0,0,61,38,23,0,0,61
504,DUR5,1,OUDS,Noren Group CG,White Mountain Ranger District,239653,A05004,5,2021,22,16,0,0,38,22,16,0,0,38
504,DUR5,1,OUDS,Trailhead Group CG (Saddlebag Lk),Mono Lake Ranger District,239661,A05004,5,2021,6,136,0,0,142,6,136,0,0,142
504,DUR4,1,OUDS,Bitterbrush CG - proxy,White Mountain Ranger District,239664,A05004,5,2021,341,673,65,0,1079,341,673,65,0,1079
504,DUR4,1,OUDS,Lower Grays Meadow CG,Mt. Whitney Ranger District,239673,A05004,5,2021,2359,1222,119,0,3700,2359,1222,119,0,3700
